Helen of Saegaria
The lady in armor has her own secrets by Diane Wang
Release 1 / Serial number 231105 / Inform 7 v10.1.2 / D

Apartment
A shitty studio apartment, but it's a cozy kind of shitty--tiny but full of warmth, old but full of character. You like it because it's your apartment. 

The only thing that itches you about this place is that your cousin gave you a gun for Thanksgiving last year, which could be read as a kind gesture or the complete opposite, and that gun is sitting right in this room. You don't quite want to think about it, however, because the idea of a gun makes you nervous. 

It's a good thing you still have a place to return to after a day of dull work typing in numbers in an excel sheet. You're glad that you took accounting in college, because though it sucks, it now provides a roof over your head, food to fill your belly, and most importantly, a beefy computer that allows you to play the latest game, Assault on Saegaria.

Playing that game has been your routine, and you don't plan to break it tonight. 

You haven't launched the game yet.

You can see a fire extinguisher and a first aid kit here.

>ask question
Who are you directing the action to? Hint: Try this structure "[the verb] [someone] about [something]. Or "[the verb] [someone] with [something]."

>play game
You launch the game.

But before you get to the point of continuing your most recent campaign, something in your computer flashes, blinding you with bright golden light. Then you realize you're not alone anymore. A woman crashes upon you.

And if she were slender a maiden in distress, all should have been well, but this gigantic monster of a lady is in full medival armor when she lands on your head.

You could scream for help (and hope your obnoxious neighbor hears you), or you could fight. The gun your cousin gave you is sitting right there, by the way.

>ask about sword
(addressing Helen)
Why are you even carrying a sword?" you ask, still fearing for your head.

The armor lady gives you the look like you're stupid, "Because I am a knight, and I am not taking off the sword my lady bestowed me when I was knighted."

Maybe this woman is an actress because that is so method. What is her real identity, then?

>ask about identity
"Who are you? Why are you in my room?" You grumble.

"Oh sweet goddess, where are my manners?" the woman bows again. "Helen of Saegaria, champion and personal knight to Her Royal Highness, Princess Josephine. It is a pleasure to make you acquaintance."

What in the-- You blink, and blink again. The princess' knight, the final boss you fought and died countless times, stands right in front of you.

But it is only polite that you also introduce yourself.

>ask about armor
Helen just introduced herself and you move on asking her about stuff without at least telling her your name. Very polite, my dude.

>introduce
"Hi, my name is Dude," you say and offers Helen a hand to shake.

"Interesting name, Helen politely nods and shakes your hand. TO BE CONTINUED. AND GIVE MULTIPLE SCENARIOS

* * *

>play game
You launch the game.

But before you get to the point of continuing your most recent campaign, something in your computer flashes, blinding you with bright golden light. Then you realize you're not alone anymore. A woman crashes upon you.

And if she were slender a maiden in distress, all should have been well, but this gigantic monster of a lady is in full medival armor when she lands on your head.

You could scream for help (and hope your obnoxious neighbor hears you), or you could fight. The gun your cousin gave you is sitting right there, by the way.

>take gun
Nervously, you reach out ot the gun.

Taken.

>fight her with gun
(Helen with the gun)
You find yourself unable to pull the trigger as your fingers shakily hold the gun. Though murdering people in a video game is commonplace, but doing it in real life is still too viscerally disturbing.

Is there something else in the room that you might use that is made of metal?

>take extinguisher
Taken.

>fight with extinguisher
Who are you directing the action to? Hint: Try this structure "[the verb] [someone]about [something].

>fight her with extinguisher
(Helen with the fire extinguisher)
You slam the fire extinguisher into her metal chest plate, knocking her back a few steps. But just as the armor lady picks herself up, you notice the giant sword she carries, all curses are swallowed back down.

"I mean no harm, and hell, look at me! How in the heaven's name could I even harm you?" you gesticulate at your whole body, which is as skinny and frail as any other accountant's on Wall Street.

"All right. Say 'yield' and I shall back down. A knight must not attack an enemy who yields." the armor lady says with a frown. Her armor still immaculate without any scratches.

* * *

>fight
You stand up and fight yourself mentally. What a struggle.

>play game
You launch the game.

But before you get to the point of continuing your most recent campaign, something in your computer flashes, blinding you with bright golden light. Then you realize you're not alone anymore. A woman crashes upon you.

And if she were slender a maiden in distress, all should have been well, but this gigantic monster of a lady is in full medival armor when she lands on your head.

You could scream for help (and hope your obnoxious neighbor hears you), or you could fight. The gun your cousin gave you is sitting right there, by the way.

* * *

>fight
You stand up and fight yourself mentally. What a struggle.

>scream
You don't know why you want to do this, but you scream anyway. It's cathartic. It's good for your mental health as long as you get some relief from it. And you scream unti lyour next door neighbor (the ass who has loud sex and wakes you up every night) slams on your shared wall.

Shut the fuck up!" the neighbor bangs on the wall.

>play game
You launch the game.

But before you get to the point of continuing your most recent campaign, something in your computer flashes, blinding you with bright golden light. Then you realize you're not alone anymore. A woman crashes upon you.

And if she were slender a maiden in distress, all should have been well, but this gigantic monster of a lady is in full medival armor when she lands on your head.

You could scream for help (and hope your obnoxious neighbor hears you), or you could fight. The gun your cousin gave you is sitting right there, by the way.

>fight
"What in the world is going on?! Why the fuck are you in my room?!" you curse and kick into the woman's abdomen.

But that proves to be a horrible idea because of the way she is covered by heavy armor from head to toe. Not only your head hurts, but your foot hurts, too.

For someone covered in so much weight, the woman is still faster than you, and she easily tackles you to the ground. Is there something nearby that you can fight her with?

>take gun
Nervously, you reach out ot the gun.

Taken.

>fight with gun
Hint: Try "ask [someone]about" something.

>fight her with gun
(Helen with the gun)
You find yourself unable to pull the trigger as your fingers shakily hold the gun. Though murdering people in a video game is commonplace, but doing it in real life is still too viscerally disturbing.

Is there something else in the room that you might use that is made of metal?

* * *

>help fire extinguisher
You can only do that to something animate.

>help yourself
Who are you directing the action to? Hint: Try this structure "[the verb] [someone] about [something]. Or "[the verb] [someone] with [something]."

>help yourself with fire extinguisher
Who are you directing the action to? Hint: Try this structure "[the verb] [someone] about [something]. Or "[the verb] [someone] with [something]."

>play game
You launch the game.

But before you get to the point of continuing your most recent campaign, something in your computer flashes, blinding you with bright golden light. Then you realize you're not alone anymore. A woman crashes upon you.

And if she were slender a maiden in distress, all should have been well, but this gigantic monster of a lady is in full medival armor when she lands on your head.

You could scream for help (and hope your obnoxious neighbor hears you), or you could fight. The gun your cousin gave you is sitting right there, by the way.

>help helen with fire extinguisher
She doesn't need help right now.

>test screaming
>--> The following tests are available:
'test identity'
'test fighting'
'test showing'

>test identity
(Testing.)

>[1] play game
The game is already turned on.

>[2] ask about her identity
(addressing Helen)
"Who are you? Why are you in my room?" You grumble.

"Oh sweet goddess, where are my manners?" the woman bows again. "Helen of Saegaria, champion and personal knight to Her Royal Highness, Princess Josephine. It is a pleasure to make you acquaintance."

What in the-- You blink, and blink again. The princess' knight, the final boss you fought and died countless times, stands right in front of you.

But it is only polite that you also introduce yourself.

>[3] introduce
"Hi, my name is Dude," you say and offers Helen a hand to shake.

"Interesting name, Helen shakes your hand and says nothing more. However, you know she is only being polite.

"Erm, so, why are you here?" you ask. "I mean, you're the final boss in Assault on Saegaria. How did you get here?"

Helen's brows furrow, "What are you even talking about? Did I hit your head too hard?"

"No, but you are the most famous and infamous character in this game!

"A game?" Helen is clearly ruffled. "Are you declaring that my honor and my service to the crown is nothing but a game to you?"

Is there a way to tell her about the game, so she understands what you're talking about? Or you can just show her the game?

>test showing
(Testing.)

>[1] tell her about game
(Helen about the Assault on Saegaria)
Helen stares at you, "What you just told me might be the most ludicrous thing I have ever been told."

Maybe the only way to convince Helen is to show her the game.

>[2] show her the game
(to Helen)
"Just look!" you turn the computer monitor to Helen's direction.

"What form of sorcery is this?" Helen jumps back, flashed and confused and alarmed by the animation.

"No! Look at that avatar! That is you!" you points and turns your face to the screen and-- No, the tile Helen is supposed to be standing on is empty, and you suddenly recall that is because she is right here with you.

But Helen stops, her eyes fixed on the NPC standing on the castle balcony. Princess Josephine looks out of the window, distressed and lonely.

"Josie must be wondering where I am..." You seem to hear her whisper.

"Josie?" you frown. That name doesn't ring a bell at all. Is it a new NPC in the next update that Helen is aware of (because hell, she is literally from that world)?

"No, I didn't say anything," Helen clears her throat, looking stern once again."

But the next second, another player appears behind Princess Josephine, and at the same moment, Helen disappears into the ether.

Is she back in the game?

>play game
You launch the game just in time when Helen jumps in and blocks that player's giant axe with her shield. Seeing her in action, now that you've known her personally, makes you feel different now.

You would've cheered whoever challenging the princess' personal knight in the past, considering you never managed to defeat Helen.

But Helen is clearly at disadvantage right now. You recognize the player's armors and equipment--the full set requires at least $3000 or some extremely good luck. And with those armors, Helen stands no chance. And eventually, Helen collapses into her own pool of blood.

"Josie," she whispers in desperation when the player snatches the princess.

And the next second, Helen reappears in your apartment, bloodied and barely alive.

Is something that you can help her with the bleeding?

>take first aid
Taken.

>help her with first aid
(Helen with the first aid kit)
TO BE CONTINUED.

* * *

>help helen
That's not a verb I recognise.

>help fire extinguisher
That's not a verb I recognise.

* * *

>help helen with
That's not a verb I recognise.

>help helen
That's not a verb I recognise.

>play game
You launch the game.

But before you get to the point of continuing your most recent campaign, something in your computer flashes, blinding you with bright golden light. Then you realize you're not alone anymore. A woman crashes upon you.

And if she were slender a maiden in distress, all should have been well, but this gigantic monster of a lady is in full medival armor when she lands on your head.

You could scream for help (and hope your obnoxious neighbor hears you), or you could fight. The gun your cousin gave you is sitting right there, by the way.

>take extinguisher
Taken.

>help helen with extinguisher
That's not a verb I recognise.

* * *

>introduce
You introduce yourself to the air. Very cool, bro.

>play game
You launch the game.

But before you get to the point of continuing your most recent campaign, something in your computer flashes, blinding you with bright golden light. Then you realize you're not alone anymore. A woman crashes upon you.

And if she were slender a maiden in distress, all should have been well, but this gigantic monster of a lady is in full medival armor when she lands on your head.

You could scream for help (and hope your obnoxious neighbor hears you), or you could fight. The gun your cousin gave you is sitting right there, by the way.

>introduce
You're too confused and scared to say anything to her.

* * *

>introduce
You introduce yourself to the air. Very cool, bro.

>say hi
There's no one here but you.

* * *

>l
Apartment
A shitty studio apartment, but it's a cozy kind of shitty--tiny but full of warmth, old but full of character. You like it because it's your apartment. 

You have a gamer PC in front of you. Playing Assault on Saegaria has been your routine, and you don't plan to break it tonight. And there is a gun in the room, which you don't want to think about.

The game is off.

You can see a fire extinguisher here.

>test identity
(Testing.)

>[1] play game
You launch the game.

But before you get to the point of continuing your most recent campaign, something in your computer flashes, blinding you with bright golden light. Then you realize you're not alone anymore. A woman crashes upon you.

And if she were slender a maiden in distress, all should have been well, but this gigantic monster of a lady is in full medival armor when she lands on your head.

You could scream for help (and hope your obnoxious neighbor hears you), or you could fight. The gun your cousin gave you is sitting right there, by the way.

>[2] ask about her identity
(addressing Helen)
"Who are you? Why are you in my room?" You grumble.

"Oh sweet goddess, where are my manners?" the woman bows again. "Helen of Saegaria, champion and personal knight to Her Royal Highness, Princess Josephine. It is a pleasure to make you acquaintance."

What in the-- You blink, and blink again. The princess' knight, the final boss you fought and died countless times, stands right in front of you.

But it is only polite that you also introduce yourself.

>l
Apartment
A shitty studio apartment, but it's a cozy kind of shitty--tiny but full of warmth, old but full of character. You like it because it's your apartment. 

You have a gamer PC in front of you. Playing Assault on Saegaria has been your routine, and you don't plan to break it tonight. And there is a gun in the room, which you don't want to think about.

The game is running.

You can see Helen and a fire extinguisher here.

>introduce self
I only understood you as far as wanting to introduce.

>introduce
"Hi, my name is Dude," you say and offers Helen a hand to shake.

"Interesting name, Helen shakes your hand and says nothing more. However, you know she is only being polite.

"Erm, so, why are you here?" you ask. "I mean, you're the final boss in Assault on Saegaria. How did you get here?"

Helen's brows furrow, "What are you even talking about? Did I hit your head too hard?"

"No, but you are the most famous and infamous character in this game!

"A game?" Helen is clearly ruffled. "Are you declaring that my honor and my service to the crown is nothing but a game to you?"

Is there a way to tell her about the game, so she understands what you're talking about? Or you can just show her the game?

>test showing
(Testing.)

>[1] tell her about game
(Helen about the Assault on Saegaria)
Helen stares at you, "What you just told me might be the most ludicrous thing I have ever been told."

Maybe the only way to convince Helen is to show her the game.

>[2] show her about game
Who are you directing the action to? Hint: Try this structure "[the verb] [someone] about [something]. Or "[the verb] [someone] with [something]."

>show Helen the game
"Just look!" you turn the computer monitor to Helen's direction.

"What form of sorcery is this?" Helen jumps back, flashed and confused and alarmed by the animation.

"No! Look at that avatar! That is you!" you points and turns your face to the screen and-- No, the tile Helen is supposed to be standing on is empty, and you suddenly recall that is because she is right here with you.

But Helen stops, her eyes fixed on the NPC standing on the castle balcony. Princess Josephine looks out of the window, distressed and lonely.

"Josie must be wondering where I am..." You seem to hear her whisper.

"Josie?" you frown. That name doesn't ring a bell at all. Is it a new NPC in the next update that Helen is aware of (because hell, she is literally from that world)?

"No, I didn't say anything," Helen clears her throat, looking stern once again."

But the next second, another player appears behind Princess Josephine, and at the same moment, Helen disappears into the ether. Is she back in the game? You need to play and see what is going on.

>play game
The game is already turned on.

* * *

>play game
You launch the game.

But before you get to the point of continuing your most recent campaign, something in your computer flashes, blinding you with bright golden light. Then you realize you're not alone anymore. A woman crashes upon you.

And if she were slender a maiden in distress, all should have been well, but this gigantic monster of a lady is in full medieval armor when she lands on your head.

You could scream for help (and hope your obnoxious neighbor hears you), or you could fight. The gun your cousin gave you is sitting right there, by the way.

>ask about her
(addressing Helen)
There is no reply.

>ask about identity
"Who are you? Why are you in my room?" You grumble.

"Oh sweet goddess, where are my manners?" the woman bows again. "Helen of Saegaria, champion and personal knight to Her Royal Highness, Princess Josephine. It is a pleasure to make you acquaintance."

What in the-- You blink, and blink again. The princess' knight, the final boss you fought and died countless times, stands right in front of you.

But it is only polite that you also introduce yourself.

>ask about identity
"Me?" Helen didn't expect you to ask about her life. "Well, I tend to Her Highness, making sure she is safe in any situation. She hasn't been too happy since betrothed, so... I strive to make her happy. Sometimes it's flowers, sometimes..." She stops. "Forgive me. I digress."

* * *

>play game
You launch the game.

But before you get to the point of continuing your most recent campaign, something in your computer flashes, blinding you with bright golden light. Then you realize you're not alone anymore. A woman crashes upon you.

And if she were slender a maiden in distress, all should have been well, but this gigantic monster of a lady is in full medieval armor when she lands on your head.

You could scream for help (and hope your obnoxious neighbor hears you), or you could fight. The gun your cousin gave you is sitting right there, by the way.

>ask about her name
(addressing Helen)
"Who are you? Why are you in my room?" You grumble.

"Oh sweet goddess, where are my manners?" the woman bows again. "Helen of Saegaria, champion and personal knight to Her Royal Highness, Princess Josephine. It is a pleasure to make you acquaintance."

What in the-- You blink, and blink again. The princess' knight, the final boss you fought and died countless times, stands right in front of you.

But it is only polite that you also introduce yourself.

>ask her about the sword
(Helen about the sword)
Helen just introduced herself and you move on asking her about stuff without at least telling her your name. Very polite, my dude.

>introduce self
"Hi, my name is Dude," you say and offers Helen a hand to shake.

"Interesting name, Helen shakes your hand and says nothing more. However, you know she is only being polite.

"Erm, so, why are you here?" you ask. "I mean, you're the final boss in Assault on Saegaria. How did you get here?"

Helen's brows furrow, "What are you even talking about? Did I hit your head too hard?"

"No, but you are the most famous and infamous character in this game!

"A game?" Helen is clearly ruffled. "Are you declaring that my honor and my service to the crown is nothing but a game to you?"

Is there a way to tell her about the game, so she understands what you're talking about? Or you can just show her the game?

>ask about the sword
"That is some fancy sword," you say. "May I try?"

Helen sizes you up again and shakes her head, "I am afraid if I allowed you to try, you'd tear your arm and injure your shoulders. This is very heavy."

>ask her about the armor
(Helen about the armor)
"Did the princess give you those armors, too?" you ask.

Helen's eyes widen, clearly offended, "That is Her Royal Highness for you. You shall not address my lady by her name."

* * *

>play game
You launch the game.

But before you get to the point of continuing your most recent campaign, something in your computer flashes, blinding you with bright golden light. Then you realize you're not alone anymore. A woman crashes upon you.

And if she were slender a maiden in distress, all should have been well, but this gigantic monster of a lady is in full medieval armor when she lands on your head.

You could scream for help (and hope your obnoxious neighbor hears you), or you could fight. The gun your cousin gave you is sitting right there, by the way.

>ask about herself
(addressing Helen)
"Who are you? Why are you in my room?" You grumble.

"Oh sweet goddess, where are my manners?" the woman bows again. "Helen of Saegaria, champion and personal knight to Her Royal Highness, Princess Josephine. It is a pleasure to make you acquaintance."

What in the-- You blink, and blink again. The princess' knight, the final boss you fought and died countless times, stands right in front of you.

But it is only polite that you also introduce yourself.

>ask about herself
Helen just introduced herself and you move on asking her about stuff without at least telling her your name. Very polite, my dude.

* * *

>play game
You launch the game.

But before you get to the point of continuing your most recent campaign, something in your computer flashes, blinding you with bright golden light. Then you realize you're not alone anymore. A woman crashes upon you.

And if she were slender a maiden in distress, all should have been well, but this gigantic monster of a lady is in full medieval armor when she lands on your head.

You could scream for help (and hope your obnoxious neighbor hears you), or you could fight. The gun your cousin gave you is sitting right there, by the way.

>ask about sword
(addressing Helen)
There is no reply.

>ask her about sword
(Helen about the sword)
There is no reply.

* * *

>play game
You launch the game.

But before you get to the point of continuing your most recent campaign, something in your computer flashes, blinding you with bright golden light. Then you realize you're not alone anymore. A woman crashes upon you.

And if she were slender a maiden in distress, all should have been well, but this gigantic monster of a lady is in full medieval armor when she lands on your head.

You could scream for help (and hope your obnoxious neighbor hears you), or you could fight. The gun your cousin gave you is sitting right there, by the way.

>ask her about armor
(Helen about the armor)
"Did you just get out of a cosplay event? That is some impressive armor. Did you get them from Etsy?" you tell her. If there is one in town right now, you definitely are going.

"Pardon me, but I do not understand what a "cosplay" is, nor do I know about "Ezzie". Is that perhaps the title of a lord? These armors belong to the royal family of Saegaria and the Order of the Knights of Sun."

She's either too into the whole cosplay thing, or she is totally nuts. You wonder about her identity.

>ask about identity
"Who are you? Why are you in my room?" You grumble.

"Oh sweet goddess, where are my manners?" the woman bows again. "Helen of Saegaria, champion and personal knight to Her Royal Highness, Princess Josephine. It is a pleasure to make you acquaintance."

What in the-- You blink, and blink again. The princess' knight, the final boss you fought and died countless times, stands right in front of you.

But it is only polite that you also introduce yourself.

>ask about her sword
Helen just introduced herself and you move on asking her about stuff without at least telling her your name. Very polite, my dude.

>ask her about game
(Helen about the Assault on Saegaria)
Helen just introduced herself and you move on asking her about stuff without at least telling her your name. Very polite, my dude.

>ask her about fire extinguisher
(Helen about the fire extinguisher)
Helen just introduced herself and you move on asking her about stuff without at least telling her your name. Very polite, my dude.

* * *

>play game
You launch the game.

But before you get to the point of continuing your most recent campaign, something in your computer flashes, blinding you with bright golden light. Then you realize you're not alone anymore. A woman crashes upon you.

And if she were slender a maiden in distress, all should have been well, but this gigantic monster of a lady is in full medieval armor when she lands on your head.

You could scream for help (and hope your obnoxious neighbor hears you), or you could fight. The gun your cousin gave you is sitting right there, by the way.

>ask her about name
(Helen about Identity)
Helen just introduced herself and you move on asking her about stuff without at least telling her your name. Very polite, my dude.

>ask about her name
(addressing Helen)
Helen just introduced herself and you move on asking her about stuff without at least telling her your name. Very polite, my dude.

* * *

>play game
You launch the game.

But before you get to the point of continuing your most recent campaign, something in your computer flashes, blinding you with bright golden light. Then you realize you're not alone anymore. A woman crashes upon you.

And if she were slender a maiden in distress, all should have been well, but this gigantic monster of a lady is in full medieval armor when she lands on your head.

You could scream for help (and hope your obnoxious neighbor hears you), or you could fight. The gun your cousin gave you is sitting right there, by the way.

>ask her about sword
(Helen about the sword)
Why are you even carrying a sword?" you ask, still fearing for your head.

The armor lady gives you the look like you're stupid, "Because I am a knight, and I am not taking off the sword my lady bestowed me when I was knighted."

Maybe this woman is an actress because that is so method.

>ask her about identity
(Helen about Identity)
"Who are you? Why are you in my room?" You grumble.

"Oh sweet goddess, where are my manners?" the woman bows again. "Helen of Saegaria, champion and personal knight to Her Royal Highness, Princess Josephine. It is a pleasure to make you acquaintance."

What in the-- You blink, and blink again. The princess' knight, the final boss you fought and died countless times, stands right in front of you.

But it is only polite that you also introduce yourself.

>ask her about saegaria
(Helen about Saegaria)
Helen just introduced herself and you move on asking her about stuff without at least telling her your name. Very polite, my dude.

>fight
Helen is literally carrying a sword. And why are you trying to fight her now?

* * *

>play game
You launch the game.

But before you get to the point of continuing your most recent campaign, something in your computer flashes, blinding you with bright golden light. Then you realize you're not alone anymore. A woman crashes upon you.

And if she were slender a maiden in distress, all should have been well, but this gigantic monster of a lady is in full medieval armor when she lands on your head.

You could scream for help (and hope your obnoxious neighbor hears you), or you could fight. The gun your cousin gave you is sitting right there, by the way.

>fight
"What in the world is going on?! Why the fuck are you in my room?!" you curse and kick into the woman's abdomen.

But that proves to be a horrible idea because of the way she is covered by heavy armor from head to toe. Not only your head hurts, but your foot hurts, too.

For someone covered in so much weight, the woman is still faster than you, and she easily tackles you to the ground. Is there something nearby that you can fight her with?

>ask about armor
(addressing Helen)
Yo you're in the middle of the fight and want to start a conversation?

>ask about game
There is no reply.

>fight with extinguisher
Who are you directing the action to? Hint: Try this structure "[the verb] [someone] about [something]. Or "[the verb] [someone] with [something]."

>fight her with extinguisher
(Helen with the fire extinguisher)
You aren't going to punch some armor with your bare hands, are you? There is nothing in your inventory!

>take fire extinguisher
Taken.

>fight her with extinguisher
(Helen with the fire extinguisher)
You slam the fire extinguisher into her metal chest plate, knocking her back a few steps. But just as the armor lady picks herself up, you notice the giant sword she carries, all curses are swallowed back down.

"I mean no harm, and hell, look at me! How in the heaven's name could I even harm you?" you gesticulate at your whole body, which is as skinny and frail as any other accountant's on Wall Street.

"All right. Say 'yield' and I shall back down. A knight must not attack an enemy who yields." the armor lady says with a frown. Her armor still immaculate without any scratches.

>ask about sword
Yo you're in the middle of the fight and want to start a conversation?

>yield
"I yield!" you pant and feel relieved when Helen instantly sheathes her sword. "And who are you, anyway?"

"I guess I haven't properly introduced myself," Helen says with a bow. "Helen of Saegaria, champion and personal knight to Her Royal Highness, Princess Josephine. It is a pleasure to make you acquaintance."

What in the-- You blink, and blink again. The princess' knight, the final boss you fought and died countless times, stands right in front of you.

But it is only polite that you also introduce yourself.

>ask about armor
Helen just introduced herself and you move on asking her about stuff without at least telling her your name. Very polite, my dude.

* * *

>introduce
"Hi, my name is Dude," you say and offers Helen a hand to shake.

"Interesting name, Helen politely nods and shakes your hand. TO BE CONTINUED. AND GIVE MULTIPLE SCENARIOS

>ask about armor
"Did the princess give you those armors, too?" you ask.

Helen's eyes widen, clearly offended, "That is Her Royal Highness for you. You shall not address my lady by her name."

>ask about sword
"That is some fancy sword," you say. "May I try?"

Helen sizes you up again and shakes her head, "I am afraid if I allowed you to try, you'd tear your arm and injure your shoulders. This is very heavy."

>fight her
(Helen)
Try "fight" or "fight someone with something" instead.

* * *

>fight
"What in the world is going on?! Why the fuck are you in my room?!" you curse and kick into the woman's abdomen.

But that proves to be a horrible idea because of the way she is covered by heavy armor from head to toe. Not only your head hurts, but your foot hurts, too.

For someone covered in so much weight, the woman is still faster than you, and she easily tackles you to the ground. Is there something nearby that you can fight her with?

>ask about herself
(addressing Helen)
Yo you're in the middle of the fight and want to start a conversation?

* * *

>fight
"What in the world is going on?! Why the fuck are you in my room?!" you curse and kick into the woman's abdomen.

But that proves to be a horrible idea because of the way she is covered by heavy armor from head to toe. Not only your head hurts, but your foot hurts, too.

For someone covered in so much weight, the woman is still faster than you, and she easily tackles you to the ground. Is there something nearby that you can fight her with?

>ask her about elon musk
(Helen about Elon-Musk)
Yo you're in the middle of the fight and want to ask her about Elon Musk?

>ask her about armor
(Helen about the armor)
Yo you're in the middle of the fight and want to start a conversation?

* * *

>fight
"What in the world is going on?! Why the fuck are you in my room?!" you curse and kick into the woman's abdomen.

But that proves to be a horrible idea because of the way she is covered by heavy armor from head to toe. Not only your head hurts, but your foot hurts, too.

For someone covered in so much weight, the woman is still faster than you, and she easily tackles you to the ground. Is there something nearby that you can fight her with?

>ask her about excel sheet
(Helen about the Excel-sheet)
How pathetic are you, showing somebody your precious little accounting excel sheets? Also, aren't you under NDA?

>test fighting
(Testing.)

>[1] play game
The game is already turned on.

>[2] fight
"What in the world is going on?! Why the fuck are you in my room?!" you curse and kick into the woman's abdomen.

But that proves to be a horrible idea because of the way she is covered by heavy armor from head to toe. Not only your head hurts, but your foot hurts, too.

For someone covered in so much weight, the woman is still faster than you, and she easily tackles you to the ground. Is there something nearby that you can fight her with?

>[3] fight her with sword
(Helen with the sword)
You aren't going to punch some armor with your bare hands, are you? There is nothing in your inventory!

>[4] fight her with fire extinguisher
(Helen with the fire extinguisher)
You aren't going to punch some armor with your bare hands, are you? There is nothing in your inventory!

>[5] take fire extinguisher
Taken.

>[6] fight her with gun
(Helen with the gun)
You are't carrying the gun!

>[7] fight her with fire extinguisher
(Helen with the fire extinguisher)
You slam the fire extinguisher into her metal chest plate, knocking her back a few steps. But just as the armor lady picks herself up, you notice the giant sword she carries, all curses are swallowed back down.

"I mean no harm, and hell, look at me! How in the heaven's name could I even harm you?" you gesticulate at your whole body, which is as skinny and frail as any other accountant's on Wall Street.

"All right. Say 'yield' and I shall back down. A knight must not attack an enemy who yields." the armor lady says with a frown. Her armor still immaculate without any scratches.

>[8] yield
"I yield!" you pant and feel relieved when Helen instantly sheathes her sword. "And who are you, anyway?"

"I guess I haven't properly introduced myself," Helen says with a bow. "Helen of Saegaria, champion and personal knight to Her Royal Highness, Princess Josephine. It is a pleasure to make you acquaintance."

What in the-- You blink, and blink again. The princess' knight, the final boss you fought and died countless times, stands right in front of you.

But it is only polite that you also introduce yourself.

>[9] introducing
"Hi, my name is Dude," you say and offers Helen a hand to shake.

"Interesting name, Helen shakes your hand and says nothing more. However, you know she is only being polite.

"Erm, so, why are you here?" you ask. "I mean, you're the final boss in Assault on Saegaria. How did you get here?"

Helen's brows furrow, "What are you even talking about? Did I hit your head too hard?"

"No, but you are the most famous and infamous character in this game!

"A game?" Helen is clearly ruffled. "Are you declaring that my honor and my service to the crown is nothing but a game to you?"

Is there a way to tell her about the game, so she understands what you're talking about? Or you can just show her the game?

>play game
The game is already turned on.

>test showing
(Testing.)

>[1] tell her about game
(Helen about the Assault on Saegaria)
Helen stares at you, "What you just told me might be the most ludicrous thing I have ever been told."

Maybe the only way to convince Helen is to show her the game.

>[2] show her the game
(to Helen)
"Just look!" you turn the computer monitor to Helen's direction.

"What form of sorcery is this?" Helen jumps back, flashed and confused and alarmed by the animation.

"No! Look at that avatar! That is you!" you points and turns your face to the screen and-- No, the tile Helen is supposed to be standing on is empty, and you suddenly recall that is because she is right here with you.

But Helen stops, her eyes fixed on the NPC standing on the castle balcony. Princess Josephine looks out of the window, distressed and lonely.

"Josie must be wondering where I am..." You seem to hear her whisper.

"Josie?" you frown. That name doesn't ring a bell at all. Is it a new NPC in the next update that Helen is aware of (because hell, she is literally from that world)?

"No, I didn't say anything," Helen clears her throat, looking stern once again."

But the next second, another player appears behind Princess Josephine, and at the same moment, Helen disappears into the ether.

Is she back in the game?

* * *

>show fire extinguisher
(to Helen)
"What is this object? A mallet, perhaps?" Helen asks.

"It supposedly puts out a fire."

"What does 'supposedly' mean?" Helen frowns.

"I never read the manual, so I don't know how to use it anyway. Let's just hope my apartment doesn't get burned down when I cook."

Helen gives you a look that says "Please get your life together."

* * *

>fight
"What in the world is going on?! Why the fuck are you in my room?!" you curse and kick into the woman's abdomen.

But that proves to be a horrible idea because of the way she is covered by heavy armor from head to toe. Not only your head hurts, but your foot hurts, too.

For someone covered in so much weight, the woman is still faster than you, and she easily tackles you to the ground. Is there something nearby that you can fight her with?

>ask her about fire extinguisher
(Helen about the fire extinguisher)
"I have not an idea what you are inquiring about," Helen says.

* * *

>fight
"What in the world is going on?! Why the fuck are you in my room?!" you curse and kick into the woman's abdomen.

But that proves to be a horrible idea because of the way she is covered by heavy armor from head to toe. Not only your head hurts, but your foot hurts, too.

For someone covered in so much weight, the woman is still faster than you, and she easily tackles you to the ground. Is there something nearby that you can fight her with?

>ask her about sword
(Helen about the sword)
Yo you're in the middle of the fight and want to start a conversation?

>take extinguisher
Taken.

>fight her with extinguisher
(Helen with the fire extinguisher)
You slam the fire extinguisher into her metal chest plate, knocking her back a few steps. But just as the armor lady picks herself up, you notice the giant sword she carries, all curses are swallowed back down.

"I mean no harm, and hell, look at me! How in the heaven's name could I even harm you?" you gesticulate at your whole body, which is as skinny and frail as any other accountant's on Wall Street.

"All right. Say 'yield' and I shall back down. A knight must not attack an enemy who yields." the armor lady says with a frown. Her armor still immaculate without any scratches.

>sup
That's not a verb I recognise.

>ask her about sword
(Helen about the sword)
Yo you're in the middle of the fight and want to start a conversation?

>yield
"I yield!" you pant and feel relieved when Helen instantly sheathes her sword. "And who are you, anyway?"

"I guess I haven't properly introduced myself," Helen says with a bow. "Helen of Saegaria, champion and personal knight to Her Royal Highness, Princess Josephine. It is a pleasure to make you acquaintance."

What in the-- You blink, and blink again. The princess' knight, the final boss you fought and died countless times, stands right in front of you.

But it is only polite that you also introduce yourself.

>ask her about sword
(Helen about the sword)
"That is some fancy sword," you say. "May I try?"

Helen sizes you up again and shakes her head, "I am afraid if I allowed you to try, you'd tear your arm and injure your shoulders. This is very heavy."

* * *

>fight
"What in the world is going on?! Why the fuck are you in my room?!" you curse and kick into the woman's abdomen.

But that proves to be a horrible idea because of the way she is covered by heavy armor from head to toe. Not only your head hurts, but your foot hurts, too.

For someone covered in so much weight, the woman is still faster than you, and she easily tackles you to the ground. Is there something nearby that you can fight her with?

>play game
The game is already turned on.

>talk to helen
Are you trying to ask someone about something? Show someone something? Or tell someone about something?

>ask about sword
(addressing Helen)
Yo you're in the middle of the fight and want to start a conversation?

>fight
"What in the world is going on?! Why the fuck are you in my room?!" you curse and kick into the woman's abdomen.

But that proves to be a horrible idea because of the way she is covered by heavy armor from head to toe. Not only your head hurts, but your foot hurts, too.

For someone covered in so much weight, the woman is still faster than you, and she easily tackles you to the ground. Is there something nearby that you can fight her with?

>fight helen with sword
You aren't going to punch some armor with your bare hands, are you? There is nothing in your inventory!

>take gun
Nervously, you reach out ot the gun.

Taken.

>fight helen with gun
You find yourself unable to pull the trigger as your fingers shakily hold the gun. Though murdering people in a video game is commonplace, but doing it in real life is still too viscerally disturbing.

Is there something else in the room that you might use that is made of metal?

>l
Apartment
A shitty studio apartment, but it's a cozy kind of shitty--tiny but full of warmth, old but full of character. You like it because it's your apartment. 

You have a gamer PC in front of you. Playing Assault on Saegaria has been your routine, and you don't plan to break it tonight. And there is a gun in the room, which you don't want to think about.

The game is running.

You can see a fire extinguisher here.

>x fire extinguisher
You bought it not just so your renter's insurance could be cheaper, but this would serve as a good weapon as well if somebody decided to break in. This is New York City after all.

>take fire extinguisher
Taken.

>fight helen with fire extinguisher
You slam the fire extinguisher into her metal chest plate, knocking her back a few steps. But just as the armor lady picks herself up, you notice the giant sword she carries, all curses are swallowed back down.

"I mean no harm, and hell, look at me! How in the heaven's name could I even harm you?" you gesticulate at your whole body, which is as skinny and frail as any other accountant's on Wall Street.

"All right. Say 'yield' and I shall back down. A knight must not attack an enemy who yields." the armor lady says with a frown. Her armor still immaculate without any scratches.

>ask about sword
Yo you're in the middle of the fight and want to start a conversation?

* * *

>yield
"I yield!" you pant and feel relieved when Helen instantly sheathes her sword. "And who are you, anyway?"

"I guess I haven't properly introduced myself," Helen says with a bow. "Helen of Saegaria, champion and personal knight to Her Royal Highness, Princess Josephine. It is a pleasure to make you acquaintance."

What in the-- You blink, and blink again. The princess' knight, the final boss you fought and died countless times, stands right in front of you.

But it is only polite that you also introduce yourself.

>ask about sword
"That is some fancy sword," you say. "May I try?"

Helen sizes you up again and shakes her head, "I am afraid if I allowed you to try, you'd tear your arm and injure your shoulders. This is very heavy."

* * *

>fight
"What in the world is going on?! Why the fuck are you in my room?!" you curse and kick into the woman's abdomen.

But that proves to be a horrible idea because of the way she is covered by heavy armor from head to toe. Not only your head hurts, but your foot hurts, too.

For someone covered in so much weight, the woman is still faster than you, and she easily tackles you to the ground. Is there something nearby that you can fight her with?

>show helen fire extinguisher
"What is this object? A mallet, perhaps?" Helen asks.

"It supposedly puts out a fire."

"What does 'supposedly' mean?" Helen frowns.

"I never read the manual, so I don't know how to use it anyway. Let's just hope my apartment doesn't get burned down when I cook."

Helen gives you a look that says "Please get your life together."

* * *

>fight
"What in the world is going on?! Why the fuck are you in my room?!" you curse and kick into the woman's abdomen.

But that proves to be a horrible idea because of the way she is covered by heavy armor from head to toe. Not only your head hurts, but your foot hurts, too.

For someone covered in so much weight, the woman is still faster than you, and she easily tackles you to the ground. Is there something nearby that you can fight her with?

>show helen pc
(first taking the PC)
Pardon me, but why are you trying to fit a computer that weighs at least 40 lbs into your pocket?

>show her first aid
(to Helen)
(first taking the first aid kit)
Maybe show her this thing at another time when you are not fighting for your life!

>fight with fire extinguisher
Who are you directing the action to? Hint: Try this structure "[the verb] [someone] about [something]. Or "[the verb] [someone] with [something]."

>show her fire extinguisher
(to Helen)
(first taking the fire extinguisher)
Maybe show her this thing at another time when you are not fighting for your life!

>fight her with fire extinguisher
(Helen with the fire extinguisher)
You slam the fire extinguisher into her metal chest plate, knocking her back a few steps. But just as the armor lady picks herself up, you notice the giant sword she carries, all curses are swallowed back down.

"I mean no harm, and hell, look at me! How in the heaven's name could I even harm you?" you gesticulate at your whole body, which is as skinny and frail as any other accountant's on Wall Street.

"All right. Say 'yield' and I shall back down. A knight must not attack an enemy who yields." the armor lady says with a frown. Her armor still immaculate without any scratches.

>show her fire extinguisher
(to Helen)
Maybe show her this thing at another time when you are not fighting for your life!

>yield
"I yield!" you pant and feel relieved when Helen instantly sheathes her sword. "And who are you, anyway?"

"I guess I haven't properly introduced myself," Helen says with a bow. "Helen of Saegaria, champion and personal knight to Her Royal Highness, Princess Josephine. It is a pleasure to make you acquaintance."

What in the-- You blink, and blink again. The princess' knight, the final boss you fought and died countless times, stands right in front of you.

But it is only polite that you also introduce yourself.

>show her fire extinguisher
(to Helen)
Helen is unimpressed.

* * *

>fight
"What in the world is going on?! Why the fuck are you in my room?!" you curse and kick into the woman's abdomen.

But that proves to be a horrible idea because of the way she is covered by heavy armor from head to toe. Not only your head hurts, but your foot hurts, too.

For someone covered in so much weight, the woman is still faster than you, and she easily tackles you to the ground. Is there something nearby that you can fight her with?

>show helen the game
Why are you trying to show her the game now, out of a sudden?

>ask about Her Highness
Yo you're in the middle of the fight and want to start a conversation?

* * *

>show helen the game
Why are you trying to show her the game now, out of a sudden?

>show helen fire extinguisher
(first taking the fire extinguisher)
"What is this object? A mallet, perhaps?" Helen asks.

"It supposedly puts out a fire."

"What does 'supposedly' mean?" Helen frowns.

"I never read the manual, so I don't know how to use it anyway. Let's just hope my apartment doesn't get burned down when I cook."

Helen gives you a look that says "Please get your life together."

* * *

>fight
"What in the world is going on?! Why the fuck are you in my room?!" you curse and kick into the woman's abdomen.

But that proves to be a horrible idea because of the way she is covered by heavy armor from head to toe. Not only your head hurts, but your foot hurts, too.

For someone covered in so much weight, the woman is still faster than you, and she easily tackles you to the ground. Is there something nearby that you can fight her with?

>show her fire extinguisher
(to Helen)
Maybe show her this thing at another time when you are not fighting for your life!

>ask her about armor
(Helen about the armor)
Yo you're in the middle of the fight and want to start a conversation?

>test fighting
(Testing.)

>[1] play game
The game is already turned on.

>[2] fight
"What in the world is going on?! Why the fuck are you in my room?!" you curse and kick into the woman's abdomen.

But that proves to be a horrible idea because of the way she is covered by heavy armor from head to toe. Not only your head hurts, but your foot hurts, too.

For someone covered in so much weight, the woman is still faster than you, and she easily tackles you to the ground. Is there something nearby that you can fight her with?

>[3] fight her with sword
(Helen with the sword)
You aren't going to punch some armor with your bare hands, are you? There is nothing in your inventory!

>[4] fight her with fire extinguisher
(Helen with the fire extinguisher)
You aren't going to punch some armor with your bare hands, are you? There is nothing in your inventory!

>[5] take fire extinguisher
Taken.

>[6] fight her with gun
(Helen with the gun)
You are't carrying the gun!

>[7] fight her with fire extinguisher
(Helen with the fire extinguisher)
You slam the fire extinguisher into her metal chest plate, knocking her back a few steps. But just as the armor lady picks herself up, you notice the giant sword she carries, all curses are swallowed back down.

"I mean no harm, and hell, look at me! How in the heaven's name could I even harm you?" you gesticulate at your whole body, which is as skinny and frail as any other accountant's on Wall Street.

"All right. Say 'yield' and I shall back down. A knight must not attack an enemy who yields." the armor lady says with a frown. Her armor still immaculate without any scratches.

>[8] yield
"I yield!" you pant and feel relieved when Helen instantly sheathes her sword. "And who are you, anyway?"

"I guess I haven't properly introduced myself," Helen says with a bow. "Helen of Saegaria, champion and personal knight to Her Royal Highness, Princess Josephine. It is a pleasure to make you acquaintance."

What in the-- You blink, and blink again. The princess' knight, the final boss you fought and died countless times, stands right in front of you.

But it is only polite that you also introduce yourself.

>[9] introducing
"Hi, my name is Dude," you say and offers Helen a hand to shake.

"Interesting name, Helen shakes your hand and says nothing more. However, you know she is only being polite.

"Erm, so, why are you here?" you ask. "I mean, you're the final boss in Assault on Saegaria. How did you get here?"

Helen's brows furrow, "What are you even talking about? Did I hit your head too hard?"

"No, but you are the most famous and infamous character in this game!

"A game?" Helen is clearly ruffled. "Are you declaring that my honor and my service to the crown is nothing but a game to you?"

Is there a way to tell her about the game, so she understands what you're talking about? Or you can just show her the game?

>show her fire extinguisher
(to Helen)
Helen is unimpressed.

>show her the game
(to Helen)
"Just look!" you turn the computer monitor to Helen's direction.

"What form of sorcery is this?" Helen jumps back, flashed and confused and alarmed by the animation.

"No! Look at that avatar! That is you!" you points and turns your face to the screen and-- No, the tile Helen is supposed to be standing on is empty, and you suddenly recall that is because she is right here with you.

But Helen stops, her eyes fixed on the NPC standing on the castle balcony. Princess Josephine looks out of the window, distressed and lonely.

"Josie must be wondering where I am..." You seem to hear her whisper.

"Josie?" you frown. That name doesn't ring a bell at all. Is it a new NPC in the next update that Helen is aware of (because hell, she is literally from that world)?

"No, I didn't say anything," Helen clears her throat, looking stern once again."

But the next second, another player appears behind Princess Josephine, and at the same moment, Helen disappears into the ether.

Is she back in the game?

>play game
You launch the game just in time when Helen jumps in and blocks that player's giant axe with her shield. Seeing her in action, now that you've known her personally, makes you feel different now.

You would've cheered whoever challenging the princess' personal knight in the past, considering you never managed to defeat Helen.

But Helen is clearly at disadvantage right now. You recognize the player's armors and equipment--the full set requires at least $3000 or some extremely good luck. And with those armors, Helen stands no chance. And eventually, Helen collapses into her own pool of blood.

"Josie," she whispers in desperation when the player snatches the princess.

And the next second, Helen reappears in your apartment, bloodied and barely alive.

Is something that you can help her with to stop the bleeding?

>show her fire extinguisher
(to Helen)
Helen is bleeding so much! Stop wasting time and heal her!

>show her first aid
(to Helen)
Helen is bleeding so much! Stop wasting time and heal her!

>help helen with first aid
You aren't carrying the first aid kit!

>take first aid
Taken.

>help helen with first aid
Miraculously, Helen's wounds start fading once the dressing touches her skin. Maybe it's a game NPC superpower or something.

"You gotta learn to pick your fight wisely," you tell her. "One look at that guy, you should've known you stood no chance. Pay-to-win has been a big issue with this game."

"But I can't let anyone hurt my princess. At first I just thought it was her betrothed causing trouble at the border that caused the invasion, but now..." Helen sighs. "I can't understand why you people found killing us fun, taking Josie like a-."

Helen stops, realizing she has slipped.

>ask her about saegaria
(Helen about Saegaria)
"...I only hope everybody is safe--she, is safe," Helen closes her eyes.

>show her saegaria
Who are you directing the action to? Hint: Try this structure "[the verb] [someone] about [something]. Or "[the verb] [someone] with [something]."

>show her first aid
(to Helen)
Helen is unimpressed.

>show her fire extinguisher
(to Helen)
Helen is unimpressed.

* * *

>show her fire extinguisher
(to Helen)
Maybe show her this thing at another time when you are not fighting for your life!

>show her pc
(to Helen)
"Not interested," Helen tell you.

Maybe show her this thing at another time when you are not fighting for your life!

* * *

>show her fire extinguisher
(to Helen)
Maybe show her this thing at another time when you are not fighting for your life!

>test fighting
(Testing.)

>[1] play game
The game is already turned on.

>[2] fight
"What in the world is going on?! Why the fuck are you in my room?!" you curse and kick into the woman's abdomen.

But that proves to be a horrible idea because of the way she is covered by heavy armor from head to toe. Not only your head hurts, but your foot hurts, too.

For someone covered in so much weight, the woman is still faster than you, and she easily tackles you to the ground. Is there something nearby that you can fight her with?

>[3] fight her with sword
(Helen with the sword)
You aren't going to punch some armor with your bare hands, are you? There is nothing in your inventory!

>[4] fight her with fire extinguisher
(Helen with the fire extinguisher)
You aren't going to punch some armor with your bare hands, are you? There is nothing in your inventory!

>[5] take fire extinguisher
Taken.

>[6] fight her with gun
(Helen with the gun)
You are't carrying the gun!

>[7] fight her with fire extinguisher
(Helen with the fire extinguisher)
You slam the fire extinguisher into her metal chest plate, knocking her back a few steps. But just as the armor lady picks herself up, you notice the giant sword she carries, all curses are swallowed back down.

"I mean no harm, and hell, look at me! How in the heaven's name could I even harm you?" you gesticulate at your whole body, which is as skinny and frail as any other accountant's on Wall Street.

"All right. Say 'yield' and I shall back down. A knight must not attack an enemy who yields." the armor lady says with a frown. Her armor still immaculate without any scratches.

>[8] yield
"I yield!" you pant and feel relieved when Helen instantly sheathes her sword. "And who are you, anyway?"

"I guess I haven't properly introduced myself," Helen says with a bow. "Helen of Saegaria, champion and personal knight to Her Royal Highness, Princess Josephine. It is a pleasure to make you acquaintance."

What in the-- You blink, and blink again. The princess' knight, the final boss you fought and died countless times, stands right in front of you.

But it is only polite that you also introduce yourself.

>[9] introducing
"Hi, my name is Dude," you say and offers Helen a hand to shake.

"Interesting name, Helen shakes your hand and says nothing more. However, you know she is only being polite.

"Erm, so, why are you here?" you ask. "I mean, you're the final boss in Assault on Saegaria. How did you get here?"

Helen's brows furrow, "What are you even talking about? Did I hit your head too hard?"

"No, but you are the most famous and infamous character in this game!

"A game?" Helen is clearly ruffled. "Are you declaring that my honor and my service to the crown is nothing but a game to you?"

Is there a way to tell her about the game, so she understands what you're talking about? Or you can just show her the game?

>test showing
(Testing.)

>[1] tell her about game
(Helen about the Assault on Saegaria)
Helen stares at you, "What you just told me might be the most ludicrous thing I have ever been told."

Maybe the only way to convince Helen is to show her the game.

>[2] show her the game
(to Helen)
"Just look!" you turn the computer monitor to Helen's direction.

"What form of sorcery is this?" Helen jumps back, flashed and confused and alarmed by the animation.

"No! Look at that avatar! That is you!" you points and turns your face to the screen and-- No, the tile Helen is supposed to be standing on is empty, and you suddenly recall that is because she is right here with you.

But Helen stops, her eyes fixed on the NPC standing on the castle balcony. Princess Josephine looks out of the window, distressed and lonely.

"Josie must be wondering where I am..." You seem to hear her whisper.

"Josie?" you frown. That name doesn't ring a bell at all. Is it a new NPC in the next update that Helen is aware of (because hell, she is literally from that world)?

"No, I didn't say anything," Helen clears her throat, looking stern once again."

But the next second, another player appears behind Princess Josephine, and at the same moment, Helen disappears into the ether.

Is she back in the game?

* * *

>show her first aid
(to Helen)
something.

(first taking the first aid kit)
Helen is bleeding so much! Stop wasting time and heal her!

>show her pc
(to Helen)
"Not interested," Helen tell you.

* * *

>show her fire extinguisher
(to Helen)
Maybe show her this thing at another time when you are not fighting for your life!

>test introducing
>--> The following tests are available:
'test identity'
'test fighting'
'test showing'

>test identity
(Testing.)

>[1] play game
The game is already turned on.

>[2] ask about her identity
Yo you're in the middle of the fight and want to start a conversation?

>[3] introduce
You're too confused and scared to say anything to her.

>test fighting
(Testing.)

>[1] play game
The game is already turned on.

>[2] fight
"What in the world is going on?! Why the fuck are you in my room?!" you curse and kick into the woman's abdomen.

But that proves to be a horrible idea because of the way she is covered by heavy armor from head to toe. Not only your head hurts, but your foot hurts, too.

For someone covered in so much weight, the woman is still faster than you, and she easily tackles you to the ground. Is there something nearby that you can fight her with?

>[3] fight her with sword
(Helen with the sword)
You aren't going to punch some armor with your bare hands, are you? There is nothing in your inventory!

>[4] fight her with fire extinguisher
(Helen with the fire extinguisher)
You aren't going to punch some armor with your bare hands, are you? There is nothing in your inventory!

>[5] take fire extinguisher
Taken.

>[6] fight her with gun
(Helen with the gun)
You are't carrying the gun!

>[7] fight her with fire extinguisher
(Helen with the fire extinguisher)
You slam the fire extinguisher into her metal chest plate, knocking her back a few steps. But just as the armor lady picks herself up, you notice the giant sword she carries, all curses are swallowed back down.

"I mean no harm, and hell, look at me! How in the heaven's name could I even harm you?" you gesticulate at your whole body, which is as skinny and frail as any other accountant's on Wall Street.

"All right. Say 'yield' and I shall back down. A knight must not attack an enemy who yields." the armor lady says with a frown. Her armor still immaculate without any scratches.

>[8] yield
"I yield!" you pant and feel relieved when Helen instantly sheathes her sword. "And who are you, anyway?"

"I guess I haven't properly introduced myself," Helen says with a bow. "Helen of Saegaria, champion and personal knight to Her Royal Highness, Princess Josephine. It is a pleasure to make you acquaintance."

What in the-- You blink, and blink again. The princess' knight, the final boss you fought and died countless times, stands right in front of you.

But it is only polite that you also introduce yourself.

>[9] introducing
"Hi, my name is Dude," you say and offers Helen a hand to shake.

"Interesting name, Helen shakes your hand and says nothing more. However, you know she is only being polite.

"Erm, so, why are you here?" you ask. "I mean, you're the final boss in Assault on Saegaria. How did you get here?"

Helen's brows furrow, "What are you even talking about? Did I hit your head too hard?"

"No, but you are the most famous and infamous character in this game!

"A game?" Helen is clearly ruffled. "Are you declaring that my honor and my service to the crown is nothing but a game to you?"

Is there a way to tell her about the game, so she understands what you're talking about? Or you can just show her the game?

* * *

>play game
You launch the game just in time when Helen jumps in and blocks that player's giant axe with her shield. Seeing her in action, now that you've known her personally, makes you feel different now.

You would've cheered whoever challenging the princess' personal knight in the past, considering you never managed to defeat Helen.

But Helen is clearly at disadvantage right now. You recognize the player's armors and equipment--the full set requires at least $3000 or some extremely good luck. And with those armors, Helen stands no chance. And eventually, Helen collapses into her own pool of blood.

"Josie," she whispers in desperation when the player snatches the princess.

And the next second, Helen reappears in your apartment, bloodied and barely alive.

Is something that you can help her with to stop the bleeding?

>show her first aid
(to Helen)
something.

Helen is bleeding so much! Stop wasting time and heal her!

* * *

>fight
"What in the world is going on?! Why the fuck are you in my room?!" you curse and kick into the woman's abdomen.

But that proves to be a horrible idea because of the way she is covered by heavy armor from head to toe. Not only your head hurts, but your foot hurts, too.

For someone covered in so much weight, the woman is still faster than you, and she easily tackles you to the ground. Is there something nearby that you can fight her with?

>show her pc
(to Helen)
"Not interested," Helen tell you.

(first taking the PC)
Pardon me, but why are you trying to fit a computer that weighs at least 40 lbs into your pocket?

>ask helen about pc
Yo you're in the middle of the fight and want to start a conversation?

>ask her about fire extinguisher
(Helen about the fire extinguisher)
Yo you're in the middle of the fight and want to start a conversation?

>show her fire extinguisher
(to Helen)
(first taking the fire extinguisher)
"What is this object? A mallet, perhaps?" Helen asks.

"It supposedly puts out a fire."

"What does 'supposedly' mean?" Helen frowns.

"I never read the manual, so I don't know how to use it anyway. Let's just hope my apartment doesn't get burned down when I cook."

Helen gives you a look that says "Please get your life together."

* * *

>show her pc
(to Helen)
"Not interested," Helen tell you.

(first taking the PC)
Pardon me, but why are you trying to fit a computer that weighs at least 40 lbs into your pocket?

>show her first aid
(to Helen)
Test test test.

(first taking the first aid kit)
Maybe show her this thing at another time when you are not fighting for your life!

>ask about first aid
Yo you're in the middle of the fight and want to start a conversation?

* * *

>fight
"What in the world is going on?! Why the fuck are you in my room?!" you curse and kick into the woman's abdomen.

But that proves to be a horrible idea because of the way she is covered by heavy armor from head to toe. Not only your head hurts, but your foot hurts, too.

For someone covered in so much weight, the woman is still faster than you, and she easily tackles you to the ground. Is there something nearby that you can fight her with?

>show her the pc
(to Helen)
Maybe show her this thing at another time when you are not fighting for your life!

>ask about saegaria
Yo you're in the middle of the fight and want to start a conversation?

>fight her with fire extinguisher
(Helen with the fire extinguisher)
You aren't going to punch some armor with your bare hands, are you? There is nothing in your inventory!

>take fire extinguishe
Taken.

>fight her with fire extinguisher
(Helen with the fire extinguisher)
You slam the fire extinguisher into her metal chest plate, knocking her back a few steps. But just as the armor lady picks herself up, you notice the giant sword she carries, all curses are swallowed back down.

"I mean no harm, and hell, look at me! How in the heaven's name could I even harm you?" you gesticulate at your whole body, which is as skinny and frail as any other accountant's on Wall Street.

"All right. Say 'yield' and I shall back down. A knight must not attack an enemy who yields." the armor lady says with a frown. Her armor still immaculate without any scratches.

>show her pc
(to Helen)
Maybe show her this thing at another time when you are not fighting for your life!

>yield
"I yield!" you pant and feel relieved when Helen instantly sheathes her sword. "And who are you, anyway?"

"I guess I haven't properly introduced myself," Helen says with a bow. "Helen of Saegaria, champion and personal knight to Her Royal Highness, Princess Josephine. It is a pleasure to make you acquaintance."

What in the-- You blink, and blink again. The princess' knight, the final boss you fought and died countless times, stands right in front of you.

But it is only polite that you also introduce yourself.

>show her pc
(to Helen)
(first taking the PC)
Pardon me, but why are you trying to fit a computer that weighs at least 40 lbs into your pocket?

>show her fire extinguisher
(to Helen)
"What is this object? A mallet, perhaps?" Helen asks.

"It supposedly puts out a fire."

"What does 'supposedly' mean?" Helen frowns.

"I never read the manual, so I don't know how to use it anyway. Let's just hope my apartment doesn't get burned down when I cook."

Helen gives you a look that says "Please get your life together."

>introduce self
"Hi, my name is Dude," you say and offers Helen a hand to shake.

"Interesting name, Helen shakes your hand and says nothing more. However, you know she is only being polite.

"Erm, so, why are you here?" you ask. "I mean, you're the final boss in Assault on Saegaria. How did you get here?"

Helen's brows furrow, "What are you even talking about? Did I hit your head too hard?"

"No, but you are the most famous and infamous character in this game!

"A game?" Helen is clearly ruffled. "Are you declaring that my honor and my service to the crown is nothing but a game to you?"

Is there a way to tell her about the game, so she understands what you're talking about? Or you can just show her the game?

>show her fire extinguisher
(to Helen)
"What is this object? A mallet, perhaps?" Helen asks.

"It supposedly puts out a fire."

"What does 'supposedly' mean?" Helen frowns.

"I never read the manual, so I don't know how to use it anyway. Let's just hope my apartment doesn't get burned down when I cook."

Helen gives you a look that says "Please get your life together."

>show her pc
(to Helen)
(first taking the PC)
Pardon me, but why are you trying to fit a computer that weighs at least 40 lbs into your pocket?

>show her first aid
(to Helen)
(first taking the first aid kit)
Test test test.

Helen is unimpressed.

* * *

>fight
"What in the world is going on?! Why the fuck are you in my room?!" you curse and kick into the woman's abdomen.

But that proves to be a horrible idea because of the way she is covered by heavy armor from head to toe. Not only your head hurts, but your foot hurts, too.

For someone covered in so much weight, the woman is still faster than you, and she easily tackles you to the ground. Is there something nearby that you can fight her with?

>take fire extinguisher
Taken.

>fight her with fire extinguisher
(Helen with the fire extinguisher)
You slam the fire extinguisher into her metal chest plate, knocking her back a few steps. But just as the armor lady picks herself up, you notice the giant sword she carries, all curses are swallowed back down.

"I mean no harm, and hell, look at me! How in the heaven's name could I even harm you?" you gesticulate at your whole body, which is as skinny and frail as any other accountant's on Wall Street.

"All right. Say 'yield' and I shall back down. A knight must not attack an enemy who yields." the armor lady says with a frown. Her armor still immaculate without any scratches.

>yield
"I yield!" you pant and feel relieved when Helen instantly sheathes her sword. "And who are you, anyway?"

"I guess I haven't properly introduced myself," Helen says with a bow. "Helen of Saegaria, champion and personal knight to Her Royal Highness, Princess Josephine. It is a pleasure to make you acquaintance."

What in the-- You blink, and blink again. The princess' knight, the final boss you fought and died countless times, stands right in front of you.

But it is only polite that you also introduce yourself.

>show her pc
(to Helen)
Helen just introduced herself and you move on asking her about stuff without at least telling her your name. Very polite, my dude.

>introduce self
"Hi, my name is Dude," you say and offers Helen a hand to shake.

"Interesting name, Helen shakes your hand and says nothing more. However, you know she is only being polite.

"Erm, so, why are you here?" you ask. "I mean, you're the final boss in Assault on Saegaria. How did you get here?"

Helen's brows furrow, "What are you even talking about? Did I hit your head too hard?"

"No, but you are the most famous and infamous character in this game!

"A game?" Helen is clearly ruffled. "Are you declaring that my honor and my service to the crown is nothing but a game to you?"

Is there a way to tell her about the game, so she understands what you're talking about? Or you can just show her the game?

* * *

>play game
You launch the game.

But before you get to the point of continuing your most recent campaign, something in your computer flashes, blinding you with bright golden light. Then you realize you're not alone anymore. A woman crashes upon you.

And if she were slender a maiden in distress, all should have been well, but this gigantic monster of a lady is in full medieval armor when she lands on your head.

You could scream for help (and hope your obnoxious neighbor hears you), or you could fight. The gun your cousin gave you is sitting right there, by the way.

>give her fire extinguisher
(to Helen)
(first taking the fire extinguisher)
Helen doesn't need a fire extinguisher now.

* * *

>play game
You launch the game.

But before you get to the point of continuing your most recent campaign, something in your computer flashes, blinding you with bright golden light. Then you realize you're not alone anymore. A woman crashes upon you.

And if she were slender a maiden in distress, all should have been well, but this gigantic monster of a lady is in full medieval armor when she lands on your head.

You could scream for help (and hope your obnoxious neighbor hears you), or you could fight. The gun your cousin gave you is sitting right there, by the way.

>give her the gun
(to Helen)
(first taking the gun)
Nervously, you reach out to the gun.

Helen doesn't want the gun right now.

>show her the gun
(to Helen)
"This object infuses the air with danger," Helen tells you.

>ask her about identity
(Helen about Identity)
"Who are you? Why are you in my room?" You grumble.

"Oh sweet goddess, where are my manners?" the woman bows again. "Helen of Saegaria, champion and personal knight to Her Royal Highness, Princess Josephine. It is a pleasure to make you acquaintance."

What in the-- You blink, and blink again. The princess' knight, the final boss you fought and died countless times, stands right in front of you.

But it is only polite that you also introduce yourself.

>show her the gun
(to Helen)
Helen just introduced herself and you move on asking her about stuff without at least telling her your name. Very polite, my dude.

>give her the gun
(to Helen)
Helen doesn't want the gun right now.

>introduce self
"Hi, my name is Dude," you say and offers Helen a hand to shake.

"Interesting name, Helen shakes your hand and says nothing more. However, you know she is only being polite.

"Erm, so, why are you here?" you ask. "I mean, you're the final boss in Assault on Saegaria. How did you get here?"

Helen's brows furrow, "What are you even talking about? Did I hit your head too hard?"

"No, but you are the most famous and infamous character in this game!

"A game?" Helen is clearly ruffled. "Are you declaring that my honor and my service to the crown is nothing but a game to you?"

Is there a way to tell her about the game, so she understands what you're talking about? Or you can just show her the game?

>give her fire extinguisher
(to Helen)
(first taking the fire extinguisher)
Helen doesn't need a fire extinguisher now.

>test showing
(Testing.)

>[1] tell her about game
(Helen about the Assault on Saegaria)
Helen stares at you, "What you just told me might be the most ludicrous thing I have ever been told."

Maybe the only way to convince Helen is to show her the game.

>[2] show her the game
(to Helen)
"Just look!" you turn the computer monitor to Helen's direction.

"What form of sorcery is this?" Helen jumps back, flashed and confused and alarmed by the animation.

"No! Look at that avatar! That is you!" you points and turns your face to the screen and-- No, the tile Helen is supposed to be standing on is empty, and you suddenly recall that is because she is right here with you.

But Helen stops, her eyes fixed on the NPC standing on the castle balcony. Princess Josephine looks out of the window, distressed and lonely.

"Josie must be wondering where I am..." You seem to hear her whisper.

"Josie?" you frown. That name doesn't ring a bell at all. Is it a new NPC in the next update that Helen is aware of (because hell, she is literally from that world)?

"No, I didn't say anything," Helen clears her throat, looking stern once again."

But the next second, another player appears behind Princess Josephine, and at the same moment, Helen disappears into the ether.

Is she back in the game?

>test healing
(Testing.)

>[1] play game
You launch the game just in time when Helen jumps in and blocks that player's giant axe with her shield. Seeing her in action, now that you've known her personally, makes you feel different now.

You would've cheered whoever challenging the princess' personal knight in the past, considering you never managed to defeat Helen.

But Helen is clearly at disadvantage right now. You recognize the player's armors and equipment--the full set requires at least $3000 or some extremely good luck. And with those armors, Helen stands no chance. And eventually, Helen collapses into her own pool of blood.

"Josie," she whispers in desperation when the player snatches the princess.

And the next second, Helen reappears in your apartment, bloodied and barely alive.

Is something that you can help her with to stop the bleeding?

>[2] take first aid
Taken.

>[3] help helen with first aid
Miraculously, Helen's wounds start fading once the dressing touches her skin. Maybe it's a game NPC superpower or something.

"You gotta learn to pick your fight wisely," you tell her. "One look at that guy, you should've known you stood no chance. Pay-to-win has been a big issue with this game."

"But I can't let anyone hurt my Josie, especially when--"

Helen stops, realizing she has slipped, saying the princess' name even.

Maybe asking her about Josie would help you understand the situation and aid Helen better.

>[4] ask her about princess
(Helen about Princess)
"Mind you, that is Her Royal Highness, Princess Josephine for you," she warns.

>[5] ask her about her highness
(Helen about Royal-Highness)
"She is my princess, but she is my Josie, too," Helen lowers her gaze.

"May I ask about Josie?" you ask, carefully.

Helen sighs, "You saved me, so... you may."

>[6] ask her about josie
(Helen about Josie)
"At first I thought I could just stay by her side forever, as a knight, even if she was to wed her betrothed. That would've been better than everything I could get" She pauses. "But then the war broke out. The enemy king wants Josie as his bride. And turns out it is only a game to you people."

"Do you have feelings for Josie?" you ask.

Helen, seemingly startled by the way you ask, shakes under your gaze. "I do," Helen says. "But she is the princess and heir to the throne, while I am only a lowly-born knight. And our gender..." Helen looks away. "Forgive me."

But now that you think about it: If players can pay to win, is there anything that can give Helen an absolutely edge in the medieval warfare? Can you give it to Helen?

>give helen the gun
"I would be careful with it," Helen tells you, taking in the gun with great care.

When the weapon touches her fingers, Helen disappears into the ether once more, and you know she is back in the game. How is she doing back in Saegaria, though? You could only find out if you play the game.

>play game
Helen faces another enemy, and with the gun, she obliterates the enemy with ease. You don't know what this means to the game world. Maybe Helen and her Josie would be safe and sound. Maybe the war will finally end.

But minutes later, the developers take the game down and annouce a hot fix to the "latest issues" in the game.

You wonder if they will be able to take away Helen's gun anyway, because that thing never existed in their code but came from the real world. You will see, and maybe Helen could come back to your apartment, if she ever found herself and Josie in trouble again, and you two could figure out something else.

    *** The End ***

Would you like to RESTART, RESTORE a saved game, QUIT or UNDO the last command?

* * *

>play game
You launch the game.

But before you get to the point of continuing your most recent campaign, something in your computer flashes, blinding you with bright golden light. Then you realize you're not alone anymore. A woman crashes upon you.

And if she were slender a maiden in distress, all should have been well, but this gigantic monster of a lady is in full medieval armor when she lands on your head.

You could scream for help (and hope your obnoxious neighbor hears you), or you could fight. The gun your cousin gave you is sitting right there, by the way.

>play game
The game is already turned on.

>talk to woman
Are you trying to ask someone about something? Show someone something? Or tell someone about something?

>x woman
She is wearing some really fancy armor and sword.

* * *

>fight
(the fire extinguisher)
Violence isn't the answer to this one.

* * *

>play game
You launch the game.

But before you get to the point of continuing your most recent campaign, something in your computer flashes, blinding you with bright golden light. Then you realize you're not alone anymore. A woman crashes upon you.

And if she were slender a maiden in distress, all should have been well, but this gigantic monster of a lady is in full medieval armor when she lands on your head.

You could scream for help (and hope your obnoxious neighbor hears you), or you could fight. The gun your cousin gave you is sitting right there, by the way.

>scream
You scream because your head hurts like hell. Because Why the heck is this person in your room?

"My sincerest apologies, my lady," the woman quickly picks her up and bows her head. "Are you injured?"

>hi
Please answer yes or no.

>no
"Of course I'm fine! I'm a real man!" you groan despite how much your head groans.

Helen frowns, sizing you up, "A man? Huh." If she's trying to stay polite you don't know, but the questioning in her look is pretty obvious to you.

"And who are you anyway?" you ask.

"Oh sweet goddess, where are my manners?" the woman bows again. "Helen of Saegaria, champion and personal knight to Her Royal Highness, Princess Josephine. It is a pleasure to make you acquaintance."

What in the-- You blink, and blink again. The princess' knight, the final boss you fought and died countless times, stands right in front of you.

But it is only polite that you also introduce yourself.

* * *

>play game
You launch the game.

But before you get to the point of continuing your most recent campaign, something in your computer flashes, blinding you with bright golden light. Then you realize you're not alone anymore. A woman crashes upon you.

And if she were slender a maiden in distress, all should have been well, but this gigantic monster of a lady is in full medieval armor when she lands on your head.

You could scream for help (and hope your obnoxious neighbor hears you), or you could fight. The gun your cousin gave you is sitting right there, by the way.

>show helen fire extinguisher
"What is this object? A mallet, perhaps?" Helen asks.

"It supposedly puts out a fire."

"What does 'supposedly' mean?" Helen frowns.

"I never read the manual, so I don't know how to use it anyway. Let's just hope my apartment doesn't get burned down when I cook."

Helen gives you a look that says "Please get your life together."

>fight
"What in the world is going on?! Why the fuck are you in my room?!" you curse and kick into the woman's abdomen.

But that proves to be a horrible idea because of the way she is covered by heavy armor from head to toe. Not only your head hurts, but your foot hurts, too.

For someone covered in so much weight, the woman is still faster than you, and she easily tackles you to the ground. Is there something nearby that you can fight her with?

>show her fire extinguisher
(to Helen)
"What is this object? A mallet, perhaps?" Helen asks.

"It supposedly puts out a fire."

"What does 'supposedly' mean?" Helen frowns.

"I never read the manual, so I don't know how to use it anyway. Let's just hope my apartment doesn't get burned down when I cook."

Helen gives you a look that says "Please get your life together."

* * *

>play game
You launch the game.

But before you get to the point of continuing your most recent campaign, something in your computer flashes, blinding you with bright golden light. Then you realize you're not alone anymore. A woman crashes upon you.

And if she were slender a maiden in distress, all should have been well, but this gigantic monster of a lady is in full medieval armor when she lands on your head.

You could scream for help (and hope your obnoxious neighbor hears you), or you could fight. The gun your cousin gave you is sitting right there, by the way.

>show her first aid
(to Helen)
(first taking the first aid kit)
"Impressive," Helen nods. "It seems you people can create something useful after all."

* * *

>play game
You launch the game.

But before you get to the point of continuing your most recent campaign, something in your computer flashes, blinding you with bright golden light. Then you realize you're not alone anymore. A woman crashes upon you.

And if she were slender a maiden in distress, all should have been well, but this gigantic monster of a lady is in full medieval armor when she lands on your head.

You could scream for help (and hope your obnoxious neighbor hears you), or you could fight. The gun your cousin gave you is sitting right there, by the way.

>show her the excel sheet
(to Helen)
(first taking the Excel-sheet)
Helen is unimpressed.

>fight
"What in the world is going on?! Why the fuck are you in my room?!" you curse and kick into the woman's abdomen.

But that proves to be a horrible idea because of the way she is covered by heavy armor from head to toe. Not only your head hurts, but your foot hurts, too.

For someone covered in so much weight, the woman is still faster than you, and she easily tackles you to the ground. Is there something nearby that you can fight her with?

>show her excel sheet
(to Helen)
Helen is unimpressed.

>show her the game
(to Helen)
Why are you trying to show her the game now, out of a sudden?

>show her fire extinguisher
(to Helen)
(first taking the fire extinguisher)
"What is this object? A mallet, perhaps?" Helen asks.

"It supposedly puts out a fire."

"What does 'supposedly' mean?" Helen frowns.

"I never read the manual, so I don't know how to use it anyway. Let's just hope my apartment doesn't get burned down when I cook."

Helen gives you a look that says "Please get your life together."

* * *

>play game
You launch the game.

But before you get to the point of continuing your most recent campaign, something in your computer flashes, blinding you with bright golden light. Then you realize you're not alone anymore. A woman crashes upon you.

And if she were slender a maiden in distress, all should have been well, but this gigantic monster of a lady is in full medieval armor when she lands on your head.

You could scream for help (and hope your obnoxious neighbor hears you), or you could fight. The gun your cousin gave you is sitting right there, by the way.

>tell her about the game
(Helen about the Assault on Saegaria)
Helen gives you a blank stare. "I have not a clue what you are talking about.

* * *

>play game
You launch the game.

But before you get to the point of continuing your most recent campaign, something in your computer flashes, blinding you with bright golden light. Then you realize you're not alone anymore. A woman crashes upon you.

And if she were slender a maiden in distress, all should have been well, but this gigantic monster of a lady is in full medieval armor when she lands on your head.

You could scream for help (and hope your obnoxious neighbor hears you), or you could fight. The gun your cousin gave you is sitting right there, by the way.

>test fighting
(Testing.)

>[1] play game
The game is already turned on.

>[2] fight
"What in the world is going on?! Why the fuck are you in my room?!" you curse and kick into the woman's abdomen.

But that proves to be a horrible idea because of the way she is covered by heavy armor from head to toe. Not only your head hurts, but your foot hurts, too.

For someone covered in so much weight, the woman is still faster than you, and she easily tackles you to the ground. Is there something nearby that you can fight her with?

>[3] fight her with sword
(Helen with the sword)
You aren't going to punch some armor with your bare hands, are you? There is nothing in your inventory!

>[4] fight her with fire extinguisher
(Helen with the fire extinguisher)
You aren't going to punch some armor with your bare hands, are you? There is nothing in your inventory!

>[5] take fire extinguisher
Taken.

>[6] fight her with gun
(Helen with the gun)
You are't carrying the gun!

>[7] fight her with fire extinguisher
(Helen with the fire extinguisher)
You slam the fire extinguisher into her metal chest plate, knocking her back a few steps. But just as the armor lady picks herself up, you notice the giant sword she carries, all curses are swallowed back down.

"I mean no harm, and hell, look at me! How in the heaven's name could I even harm you?" you gesticulate at your whole body, which is as skinny and frail as any other accountant's on Wall Street.

"All right. Say 'yield' and I shall back down. A knight must not attack an enemy who yields." the armor lady says with a frown. Her armor still immaculate without any scratches.

>[8] yield
"I yield!" you pant and feel relieved when Helen instantly sheathes her sword. "And who are you, anyway?"

"I guess I haven't properly introduced myself," Helen says with a bow. "Helen of Saegaria, champion and personal knight to Her Royal Highness, Princess Josephine. It is a pleasure to make you acquaintance."

What in the-- You blink, and blink again. The princess' knight, the final boss you fought and died countless times, stands right in front of you.

But it is only polite that you also introduce yourself.

>[9] introducing
"Hi, my name is Dude," you say and offers Helen a hand to shake.

"Interesting name, Helen shakes your hand and says nothing more. However, you know she is only being polite.

"Erm, so, why are you here?" you ask. "I mean, you're the final boss in Assault on Saegaria. How did you get here?"

Helen's brows furrow, "What are you even talking about? Did I hit your head too hard?"

"No, but you are the most famous and infamous character in this game!

"A game?" Helen is clearly ruffled. "Are you declaring that my honor and my service to the crown is nothing but a game to you?"

Is there a way to tell her about the game, so she understands what you're talking about? Or you can just show her the game?

* * *

>take first aid
Taken.

>heal her with first aid
That's not a verb I recognise.

>help her with first aid
(Helen with the first aid kit)
Miraculously, Helen's wounds start fading once the dressing touches her skin. Maybe it's a game NPC superpower or something.

"You gotta learn to pick your fight wisely," you tell her. "One look at that guy, you should've known you stood no chance. Pay-to-win has been a big issue with this game."

"But I can't let anyone hurt my princess. At first I just thought it was her betrothed causing trouble at the border that caused the invasion, but now..." Helen sighs. "I can't understand why you people found killing us fun, taking Josie like a-."

Helen stops, realizing she has slipped.

>show her first aid
(to Helen)
"Impressive," Helen nods. "It seems you people can create something useful after all."

* * *

>scream
You don't know why you want to do this, but you scream anyway. It's cathartic. It's good for your mental health as long as you get some relief from it. And you scream unti lyour next door neighbor (the ass who has loud sex and wakes you up every night) slams on your shared wall.

Shut the fuck up!" the neighbor bangs on the wall.

* * *

>play game
You launch the game.

But before you get to the point of continuing your most recent campaign, something in your computer flashes, blinding you with bright golden light. Then you realize you're not alone anymore. A woman crashes upon you.

And if she were slender a maiden in distress, all should have been well, but this gigantic monster of a lady is in full medival armor when she lands on your head.

You could scream for help (and hope your obnoxious neighbor hears you), or you could fight. The gun your cousin gave you is sitting right there, by the way.

>x gun
You're thinking about getting rid of the gun because you don't have a permit, and that is a problem in New York City.

>take gun
Nervously, you reach out ot the gun.

Taken.

>take extinguisher
Taken.

>fight
"What in the world is going on?! Why the fuck are you in my room?!" you curse and kick into the woman's abdomen.

But that proves to be a horrible idea because of the way she is covered by heavy armor from head to toe. Not only your head hurts, but your foot hurts, too.

For someone covered in so much weight, the woman is still faster than you, and she easily tackles you to the ground. Is there something nearby that you can fight her with?

>fight helen with gun
You find yourself unable to pull the trigger as your fingers shakily hold the gun. Though murdering people in a video game is commonplace, but doing it in real life is still too viscerally disturbing.

Is there something else in the room that you might use that is made of metal?

>fight with  extinguisher
Hint: Try "ask about" something.

* * *

>take gun
Nervously, you take the gun.

Taken.

* * *

>introduce self
"Hi, my name is Dude," you say and offers Helen a hand to shake.

"Interesting name, Helen shakes your hand and says nothing more. However, you know she is only being polite.

"Erm, so, why are you here?" you ask. "I mean, you're the final boss in Assault on Saegaria. How did you get here?"

Helen's brows furrow, "What are you even talking about? Did I hit your head too hard?"

"No, but you are the most famous and infamous character in this game!

"A game?" Helen is clearly ruffled. "Are you declaring that my honor and my service to the crown is nothing but a game to you?"

Is there a way to tell her about the game, so she understands what you're talking about? Or you can just show her the game?

>test showing
(Testing.)

>[1] tell her about game
(Helen about the Assault on Saegaria)
Helen stares at you, "What you just told me might be the most ludicrous thing I have ever been told."

Maybe the only way to convince Helen is to show her the game.

>[2] show her the game
(to Helen)
"Just look!" you turn the computer monitor to Helen's direction.

"What form of sorcery is this?" Helen jumps back, flashed and confused and alarmed by the animation.

"No! Look at that avatar! That is you!" you points and turns your face to the screen and-- No, the tile Helen is supposed to be standing on is empty, and you suddenly recall that is because she is right here with you.

But Helen stops, her eyes fixed on the NPC standing on the castle balcony. Princess Josephine looks out of the window, distressed and lonely.

"Josie must be wondering where I am..." You seem to hear her whisper.

"Josie?" you frown. That name doesn't ring a bell at all. Is it a new NPC in the next update that Helen is aware of (because hell, she is literally from that world)?

"No, I didn't say anything," Helen clears her throat, looking stern once again."

But the next second, another player appears behind Princess Josephine, and at the same moment, Helen disappears into the ether.

Is she back in the game?

* * *

>tell her about game
(Helen about the Assault on Saegaria)
Helen stares at you, "What you just told me might be the most ludicrous thing I have ever been told."

Maybe the only way to convince Helen is to show her the game.

>ask about the game
There is no reply.

>show her the game
(to Helen)
"Just look!" you turn the computer monitor to Helen's direction.

"What form of sorcery is this?" Helen jumps back, flashed and confused and alarmed by the animation.

"No! Look at that avatar! That is you!" you points and turns your face to the screen and-- No, the tile Helen is supposed to be standing on is empty, and you suddenly recall that is because she is right here with you.

But Helen stops, her eyes fixed on the NPC standing on the castle balcony. Princess Josephine looks out of the window, distressed and lonely.

"Josie must be wondering where I am..." You seem to hear her whisper.

"Josie?" you frown. That name doesn't ring a bell at all. Is it a new NPC in the next update that Helen is aware of (because hell, she is literally from that world)?

"No, I didn't say anything," Helen clears her throat, looking stern once again."

But the next second, another player appears behind Princess Josephine, and at the same moment, Helen disappears into the ether. Is she back in the game? You need to play and see what is going on.

(first taking the Assault on Saegaria)
That's fixed in place.

* * *

>test showing
(Testing.)

>[1] tell her about game
(Helen about the Assault on Saegaria)
Helen stares at you, "What you just told me might be the most ludicrous thing I have ever been told."

Maybe the only way to convince Helen is to show her the game.

>[2] show her the game
(to Helen)
"Just look!" you turn the computer monitor to Helen's direction.

"What form of sorcery is this?" Helen jumps back, flashed and confused and alarmed by the animation.

"No! Look at that avatar! That is you!" you points and turns your face to the screen and-- No, the tile Helen is supposed to be standing on is empty, and you suddenly recall that is because she is right here with you.

But Helen stops, her eyes fixed on the NPC standing on the castle balcony. Princess Josephine looks out of the window, distressed and lonely.

"Josie must be wondering where I am..." You seem to hear her whisper.

"Josie?" you frown. That name doesn't ring a bell at all. Is it a new NPC in the next update that Helen is aware of (because hell, she is literally from that world)?

"No, I didn't say anything," Helen clears her throat, looking stern once again."

But the next second, another player appears behind Princess Josephine, and at the same moment, Helen disappears into the ether.

Is she back in the game?

>ask her about game
You can't see 'her' (nothing) at the moment.

>play game
You launch the game just in time when Helen jumps in and blocks that player's giant axe with her shield. Seeing her in action, now that you've known her personally, makes you feel different now.

You would've cheered whoever challenging the princess' personal knight in the past, considering you never managed to defeat Helen.

But Helen is clearly at disadvantage right now. You recognize the player's armors and equipment--the full set requires at least $3000 or some extremely good luck. And with those armors, Helen stands no chance. And eventually, Helen collapses into her own pool of blood.

"Josie," she whispers in desperation when the player snatches the princess.

And the next second, Helen reappears in your apartment, bloodied and barely alive.

Is something that you can help her with to stop the bleeding?

>show her first aid
(to Helen)
Helen is bleeding so much! Stop wasting time and heal her!

>show her fire extinguisher
(to Helen)
Helen is bleeding so much! Stop wasting time and heal her!

>help her with first aid
(Helen with the first aid kit)
You aren't carrying the first aid kit!

>take first aid
Taken.

>help her with first aid
(Helen with the first aid kit)
Miraculously, Helen's wounds start fading once the dressing touches her skin. Maybe it's a game NPC superpower or something.

"You gotta learn to pick your fight wisely," you tell her. "One look at that guy, you should've known you stood no chance. Pay-to-win has been a big issue with this game."

"But I can't let anyone hurt my princess. At first I just thought it was her betrothed causing trouble at the border that caused the invasion, but now..." Helen sighs. "I can't understand why you people found killing us fun, taking Josie like a-."

Helen stops, realizing she has slipped.

>show her first aid
(to Helen)
"Impressive," Helen nods. "It seems you people can create something useful after all."

Helen is unimpressed.

* * *

>ask about armor
Helen is bleeding so much! Stop wasting time and help her!

>restart
Are you sure you want to restart?

>yes
Helen of Saegaria
The lady in armor has her own secrets by Diane Wang
Release 1 / Serial number 231102 / Inform 7 v10.1.2 / D

Apartment
A shitty studio apartment, but it's a cozy kind of shitty--tiny but full of warmth, old but full of character. You like it because it's your apartment. 

The only thing that itches you about this place is that your cousin gave you a gun for Thanksgiving last year, which could be read as a kind gesture or the complete opposite, and that gun is sitting right in this room. You don't quite want to think about it, however, because the idea of a gun makes you nervous. 

It's a good thing you still have a place to return to after a day of dull work typing in numbers in an excel sheet. You're glad that you took accounting in college, because though it sucks, it now provides a roof over your head, food to fill your belly, and most importantly, a beefy computer that allows you to play the latest game, Assault on Saegaria.

Playing that game has been your routine, and you don't plan to break it tonight. 

The game is off.

You can see a fire extinguisher and a first aid kit here.

>play game
You launch the game.

But before you get to the point of continuing your most recent campaign, something in your computer flashes, blinding you with bright golden light. Then you realize you're not alone anymore. A woman crashes upon you.

And if she were slender a maiden in distress, all should have been well, but this gigantic monster of a lady is in full medival armor when she lands on your head.

You could scream for help (and hope your obnoxious neighbor hears you), or you could fight. The gun your cousin gave you is sitting right there, by the way.

>ask about armor
(addressing Helen)
"Did you just get out of a cosplay event? That is some impressive armor. Did you get them from Etsy?" you tell her. If there is one in town right now, you definitely are going.

"Pardon me, but I do not understand what a "cosplay" is, nor do I know about "Ezzie". Is that perhaps the title of a lord? These armors belong to the royal family of Saegaria and the Order of the Knights of Sun."

She's either too into the whole cosplay thing, or she is totally nuts. You wonder about her identity.

>help
That's not a verb I recognise.

* * *

>ask helen about fire extinguisher
Helen is bleeding so much! Stop wasting time and heal her!

>ask helen about game
Helen is bleeding so much! Stop wasting time and heal her!

>show helen game
(first taking the Assault on Saegaria)
That's fixed in place.

>show helen fire extinguisher
"What is this object? A mallet, perhaps?" Helen asks.

"It supposedly puts out a fire."

"What does 'supposedly' mean?" Helen frowns.

"I never read the manual, so I don't know how to use it anyway. Let's just hope my apartment doesn't get burned down when I cook."

Helen gives you a look that says "Please get your life together."

* * *

>help her
(Helen with the fire extinguisher)
You can't possibly heal her with this thing.

>help her with first aid
(Helen with the first aid kit)
You aren't carrying the first aid kit!

* * *

>help her with first aid
(Helen with the first aid kit)
TO BE CONTINUED.

>help her
What do you want to help Helen with?

* * *

>help her with first aid
(Helen with the first aid kit)
You aren't carrying the first aid kit!

* * *

>take first aid
Taken.

>help her with first aid
(Helen with the first aid kit)
Miraculously, Helen's wounds start fading once the dressing touches her skin. Maybe it's a game NPC superpower or something.

"You gotta learn to pick your fight wisely," you tell her. "One look at that guy, you should've known you stood no chance. Pay-to-win has been a big issue with this game."

"But I can't let anyone hurt my Josie, especially when--"

Helen stops, realizing she has slipped, saying the princess' name even.

Maybe asking her about Josie would help you understand the situation and aid Helen better.

>ask her about gun
(Helen about the gun)
Helen's eyes widen, "Are you saying that any laymen without any formal training could bring on massive destruction to hundreds with this blasphemous object?"

"Well, that's about right," you shrugs.

"And your cousin acquired this thing for you?"

"Well he just gave it to me without asking if I ever wanted a gun."

"I would advice you to dispose of this weapon lest it caused you regrets," Helen frowns. "And your cousin needs help, if he ever received any."

>show her the gun
(to Helen)
(first taking the gun)
Nervously, you reach out to the gun.

"You say this is a weapon, but I have never seen any... "players" from your world brandishing such a weapon in Saegaria," Helen says.

"I think the community is more into melee than anything else. You know, melee is for tough guys," you continue. "Do you want this, though? You could really protect Her Highness well with a gun. Nobody's armor could stop a bullet, I guess."

Helen gives it another cautious look, looks away, and sighs, "Fine. I think you do have a point."

Now give the gun to Helen, and you'll be rid of this bloody weapon at last.

Helen is unimpressed.

>ask her about josie
(Helen about Josie)
"At first I thought I could just stay by her side forever, as a knight, even if she was to wed her betrothed. That would've been better than everything I could get" She pauses. "But then the war broke out. The enemy king wants Josie as his bride. And turns out it is only a game to you people."

"Do you have feelings for Josie?" you ask.

Helen, seemingly startled by the way you ask, shakes under your gaze. "I do," Helen says. "But she is the princess and heir to the throne, while I am only a lowly-born knight. And our gender..." Helen looks away. "Forgive me."

But now that you think about it: If players can pay to win, is there anything that can give Helen an absolutely edge in the medieval warfare? Can you give it to Helen?

>give her the gun
(to Helen)
"I would be careful with it," Helen tells you, taking in the gun with great care.

When the weapon touches her fingers, Helen disappears into the ether once more, and you know she is back in the game. How is she doing back in Saegaria, though? You could only find out if you play the game.

>play game
move to the end game block

* * *

>show helen fire extinguisher
Helen is bleeding so much! Stop wasting time and heal her!

>show helen first aid
Helen is bleeding so much! Stop wasting time and heal her!

>ask helen about game
Helen is bleeding so much! Stop wasting time and heal her!

>ask helen about saegaria
Helen is bleeding so much! Stop wasting time and heal her!

* * *

>show her first aid
(to Helen)
"Impressive," Helen nods. "It seems you people can create something useful after all."

Helen is unimpressed.

>track responses
Now tracking responses. Type "track off" to disable.

>show her first aid
(to Helen)
"Impressive," Helen nods. "It seems you people can create something useful after all."

[Helen is unimpressed. - type "response 1" for details]

>response 1
block showing rule response (A)

Currently:
"[The second noun] [are] unimpressed."

To change, copy and pase the following line into your source:
The block showing rule response (A) is "New response text."

* Note: if this response was defined in your own source text, of course, it's easier to change it by searching for the text in your project and updating the original.

* * *

>test screaming
(Testing.)

>[1] play game
You launch the game.

But before you get to the point of continuing your most recent campaign, something in your computer flashes, blinding you with bright golden light. Then you realize you're not alone anymore. A woman crashes upon you.

And if she were slender a maiden in distress, all should have been well, but this gigantic monster of a lady is in full medieval armor when she lands on your head.

You could scream for help (and hope your obnoxious neighbor hears you), or you could fight. The gun your cousin gave you is sitting right there, by the way.

>[2] scream
You scream because your head hurts like hell. Because Why the heck is this person in your room?

"My sincerest apologies, my lady," the woman quickly picks her up and bows her head. "Are you injured?"
[3] yes
"Just gimme a sec. My head just... ugh, hurts really bad," you groan. "And mind you, I am a man. And who are you, anyway?"

"Oh sweet goddess, where are my manners?" the woman bows again. "Helen of Saegaria, champion and personal knight to Her Royal Highness, Princess Josephine. It is a pleasure to make you acquaintance."

What in the-- You blink, and blink again. The princess' knight, the final boss you fought and died countless times, stands right in front of you.

But it is only polite that you also introduce yourself.

>[4] introduce self
"Hi, my name is Dude," you say and offers Helen a hand to shake.

"Interesting name, Helen shakes your hand and says nothing more. However, you know she is only being polite.

"Erm, so, why are you here?" you ask. "I mean, you're the final boss in Assault on Saegaria. How did you get here?"

Helen's brows furrow, "What are you even talking about? Did I hit your head too hard?"

"No, but you are the most famous and infamous character in this game!

"A game?" Helen is clearly ruffled. "Are you declaring that my honor and my service to the crown is nothing but a game to you?"

Is there a way to tell her about the game, so she understands what you're talking about? Or you can just show her the game?

>show her the game
(to Helen)
"Just look!" you turn the computer monitor to Helen's direction.

"What form of sorcery is this?" Helen jumps back, flashed and confused and alarmed by the animation.

"No! Look at that avatar! That is you!" you points and turns your face to the screen and-- No, the tile Helen is supposed to be standing on is empty, and you suddenly recall that is because she is right here with you.

But Helen stops, her eyes fixed on the NPC standing on the castle balcony. Princess Josephine looks out of the window, distressed and lonely.

"Josie must be wondering where I am..." You seem to hear her whisper.

"Josie?" you frown. That name doesn't ring a bell at all. Is it a new NPC in the next update that Helen is aware of (because hell, she is literally from that world)?

"No, I didn't say anything," Helen clears her throat, looking stern once again."

But the next second, another player appears behind Princess Josephine, and at the same moment, Helen disappears into the ether.

Is she back in the game?

>test healing
(Testing.)

>[1] play game
You launch the game just in time when Helen jumps in and blocks that player's giant axe with her shield. Seeing her in action, now that you've known her personally, makes you feel different now.

You would've cheered whoever challenging the princess' personal knight in the past, considering you never managed to defeat Helen.

But Helen is clearly at disadvantage right now. You recognize the player's armors and equipment--the full set requires at least $3000 or some extremely good luck. And with those armors, Helen stands no chance. And eventually, Helen collapses into her own pool of blood.

"Josie," she whispers in desperation when the player snatches the princess.

And the next second, Helen reappears in your apartment, bloodied and barely alive.

Is something that you can help her with to stop the bleeding?

>[2] take first aid
Taken.

>[3] help helen with first aid
Miraculously, Helen's wounds start fading once the dressing touches her skin. Maybe it's a game NPC superpower or something.

"You gotta learn to pick your fight wisely," you tell her. "One look at that guy, you should've known you stood no chance. Pay-to-win has been a big issue with this game."

"But I can't let anyone hurt my Josie, especially when--"

Helen stops, realizing she has slipped, saying the princess' name even.

Maybe asking her about Josie would help you understand the situation and aid Helen better.

>[4] ask her about princess
(Helen about Princess)
"Mind you, that is Her Royal Highness, Princess Josephine for you," she warns.

>[5] ask her about her highness
(Helen about Royal-Highness)
"She is my princess, but she is my Josie, too," Helen lowers her gaze.

"May I ask about Josie?" you ask, carefully.

Helen sighs, "You saved me, so... you may."

>[6] ask her about josie
(Helen about Josie)
"At first I thought I could just stay by her side forever, as a knight, even if she was to wed her betrothed. That would've been better than everything I could get" She pauses. "But then the war broke out. The enemy king wants Josie as his bride. And turns out it is only a game to you people."

"Do you have feelings for Josie?" you ask.

Helen, seemingly startled by the way you ask, shakes under your gaze. "I do," Helen says. "But she is the princess and heir to the throne, while I am only a lowly-born knight. And our gender..." Helen looks away. "Forgive me."

But now that you think about it: If players can pay to win, is there anything that can give Helen an absolutely edge in the medieval warfare? Can you give it to Helen?

>ask her about extinguisher
(Helen about the fire extinguisher)
"I have not an idea what you are inquiring about," Helen says.

>show her extinguisher
(to Helen)
(first taking the fire extinguisher)
"What is this object? A mallet, perhaps?" Helen asks.

"It supposedly puts out a fire."

"What does 'supposedly' mean?" Helen frowns.

"I never read the manual, so I don't know how to use it anyway. Let's just hope my apartment doesn't get burned down when I cook."

Helen gives you a look that says "Please get your life together."

>give her extinguisher
(to Helen)
"Much appreciated," Helen somehow manages to put the fire extinguisher into her pocket--game NPC superpower maybe. "This will help us reconstruct the capital once the battle is over, considering how much burning damages there have been."

>show her first aid
(to Helen)
"This healing box will put every healer in my world to shame. I would believe it would be immensely helpful to our comrades," Helen nods.

Maybe you could give this first aid kit to Helen, considering you can just get another one from CVS any other day.

>ask her about first aid
(Helen about the first aid kit)
Helen shakes her head, "We do have our medicine box back in where I am from. Bandages, potions, herbs..."

>give her first aid
(to Helen)
"Thank you," Helen takes the first aid kid. "My fellow knights and soldiers would benefit greatly from this gift."

>ask her about gun
(Helen about the gun)
Helen's eyes widen, "Are you saying that any laymen without any formal training could bring on massive destruction to hundreds with this blasphemous object?"

"Well, that's about right," you shrugs.

"And your cousin acquired this thing for you?"

"Well he just gave it to me without asking if I ever wanted a gun."

"I would advice you to dispose of this weapon lest it caused you regrets," Helen frowns. "And your cousin needs help, if he ever received any."

But it may really, really give her an edge in the game, and she wouldn't be killing real people anyway.

>show her the gun
(to Helen)
(first taking the gun)
Nervously, you reach out to the gun.

Helen is unimpressed.

>give her the gun
(to Helen)
"I would be careful with it," Helen tells you, taking in the gun with great care.

When the weapon touches her fingers, Helen disappears into the ether once more, and you know she is back in the game. How is she doing back in Saegaria, though? You could only find out if you play the game.

>play game
Helen faces another enemy, and with the gun, she obliterates the enemy with ease. You don't know what this means to the game world. Maybe Helen and her Josie would be safe and sound. Maybe the war will finally end.

But minutes later, the developers take the game down and annouce a hot fix to the "latest issues" in the game.

You wonder if they will be able to take away Helen's gun anyway, because that thing never existed in their code but came from the real world. You will see, and maybe Helen could come back to your apartment, if she ever found herself and Josie in trouble again, and you two could figure out something else.

    *** The End ***

Would you like to RESTART, RESTORE a saved game, QUIT or UNDO the last command?

>restart
Helen of Saegaria
The lady in armor has her own secrets by Diane Wang
Release 1 / Serial number 231105 / Inform 7 v10.1.2 / D

Apartment
A shitty studio apartment, but it's a cozy kind of shitty--tiny but full of warmth, old but full of character. You like it because it's your apartment. 

The only thing that itches you about this place is that your cousin gave you a gun for Thanksgiving last year, which could be read as a kind gesture or the complete opposite, and that gun is sitting right in this room. You don't quite want to think about it, however, because the idea of a gun makes you nervous. 

It's a good thing you still have a place to return to after a day of dull work typing in numbers in an excel sheet. You're glad that you took accounting in college, because though it sucks, it now provides a roof over your head, food to fill your belly, and most importantly, a beefy computer that allows you to play the latest game, Assault on Saegaria.

Playing that game has been your routine, and you don't plan to break it tonight. 

You haven't launched the game yet.

You can see a fire extinguisher and a first aid kit here.

>play game
You launch the game.

But before you get to the point of continuing your most recent campaign, something in your computer flashes, blinding you with bright golden light. Then you realize you're not alone anymore. A woman crashes upon you.

And if she were slender a maiden in distress, all should have been well, but this gigantic monster of a lady is in full medieval armor when she lands on your head.

You could scream for help (and hope your obnoxious neighbor hears you), or you could fight. The gun your cousin gave you is sitting right there, by the way.

>give helen the gun
(first taking the gun)
Nervously, you reach out to the gun.

Helen doesn't want the gun right now.

* * *

>turn on game
It isn't something you can switch.

* * *

>x gun
You're thinking about getting rid of the gun because you don't have a permit, and that is a problem in New York City.

>take gun
Taken.