DialoguePractice
An Interactive Fiction by Diane Wang
Release 1 / Serial number 231022 / Inform 7 v10.1.2 / D

Apartment
A shitty studio apartment, but it's a cozy kind of shitty--tiny but full of warmth, old but full of character. You like it because it's your apartment. 

It's a good thing you still have a place to return to after a day of dull work typing in numbers in an excel sheet. You're glad that you took accounting in college, because though it sucks, it now provides a roof over your head, food to fill your belly, and most importantly, a beefy laptop that allows you to play the latest game, Assault on Saegaria.

>accuse helen
That's not a verb I recognise.

>weak!
That's not a verb I recognise.

* * *

>i
You are carrying nothing.

* * *

>launch SaegariaGame
I only understood you as far as wanting to launch.

* * *

>launch saegariagame
You launch the game.

>launch SaegariaGame
I only understood you as far as wanting to launch.

* * *

>look
Apartment
A shitty studio apartment, but it's a cozy kind of shitty--tiny but full of warmth, old but full of character. You like it because it's your apartment. 

You have a laptop in front of you, displaying the latest version of the game, Assault on Saegaria.

* * *

>say accusation to helen
You can't see any such thing.

>deliver accusation to helen
That's not a verb I recognise.

>talk abou accusation to Helen
I didn't understand that sentence.

>talk about accusation
That noun did not make sense in this context.

>preview accusation
That's not a verb I recognise.

>preview
That's not a verb I recognise.

>i
You are carrying nothing.

[You can see topics for speaking to others by typing T or TOPICS].

>t
Things to say to Helen
    You can't think of anything at this time.

You can see just the topics for one person at a time by TALKing TO that person.

* * *

>test characters
(Testing.)

>[1] talk to helen
You say hello to Helen.

* * *

>test game
(Testing.)

>[1] x the game
Praised as Game of the Year. AAA production, real cool stuff with a bulky white dude with brown hair as the protagonist.Your goal is to take the capital city of Saegaria and snatch the princess from the castle. The final battle with princess" personal knight is considered the toughest boss fight by almost all gamers on the internet.

>[2] x game
Praised as Game of the Year. AAA production, real cool stuff with a bulky white dude with brown hair as the protagonist.Your goal is to take the capital city of Saegaria and snatch the princess from the castle. The final battle with princess" personal knight is considered the toughest boss fight by almost all gamers on the internet.

>[3] x assault
Praised as Game of the Year. AAA production, real cool stuff with a bulky white dude with brown hair as the protagonist.Your goal is to take the capital city of Saegaria and snatch the princess from the castle. The final battle with princess" personal knight is considered the toughest boss fight by almost all gamers on the internet.

>[4] x assault on saegaria.
Praised as Game of the Year. AAA production, real cool stuff with a bulky white dude with brown hair as the protagonist.Your goal is to take the capital city of Saegaria and snatch the princess from the castle. The final battle with princess" personal knight is considered the toughest boss fight by almost all gamers on the internet.

>launch game
You launch the game.

>launch game
The game is already launched.

* * *

>x pc
Expensive machine. It's sole purpose recently is only for the game, Assault on Saegaria.

>take pc
Pardon me, but why are you trying to fit a computer that weighs at least 30 lbs into your pocket?