Helen of Saegaria
An Interactive Fiction by Diane Wang
Release 1 / Serial number 231026 / Inform 7 v10.1.2 / D

Apartment
A shitty studio apartment, but it's a cozy kind of shitty--tiny but full of warmth, old but full of character. You like it because it's your apartment. 

It's a good thing you still have a place to return to after a day of dull work typing in numbers in an excel sheet. You're glad that you took accounting in college, because though it sucks, it now provides a roof over your head, food to fill your belly, and most importantly, a beefy computer that allows you to play the latest game, Assault on Saegaria.

Playing that game has been your routine, and you don't plan to break it tonight. 

You haven't launched the game yet.

You can see a fire extinguisher here.

>Take fire extinguisher
Taken.

>i
You are carrying:
  a fire extinguisher

>Play game
You launch the game.

But before you get to the point of continuing your most recent campaign, something in your computer flashes, blinding you with bright golden light. Then you realize you're not alone anymore. A woman crashes upon you.

And if she were slender a maiden in distress, all should have been well, but this gigantic monster of a lady is in full medival armor when she lands on your head.

You are about to scream in pain. You are about to fight or flight because this is New York City, and having a stranger appearing in your place out of a sudden is a bad sign.

>run
You'll have to say which compass direction to go in.

>run north
You can't go that way.

>fight
"What in the world is going on?! Why the fuck are you in my room?!" you curse and kick into the woman's abdomen.

But that proves to be a horrible idea because of the way she is covered by heavy armor from head to toe. Not only your head hurts, but your foot hurts, too.

For someone covered in so much weight, the woman is still faster than you, and she easily tackles you to the ground. You think you're getting killed, but is there something in the room that is also made of metal? Maybe you can fight her with it?

>use fire extinguisher
That's not a verb I recognise.

>fight her with fire extinguisher
(Helen with the fire extinguisher)
You slam the fire extinguisher into her metal chest plate, knocking her back a few steps. But just as the armor lady picks herself up, you notice the giant sword she carries, all curses are swallowed back down.

"I mean no harm, and hell, look at me! How in the heaven's name could I even harm you?" you gesticulate at your whole body, which is as skinny and frail as any other accountant's on Wall Street.

"All right. I must not attack an enemy who yields." the armor lady says with a frown. Her armor still immaculate without any scratches.

>flight
That's not a verb I recognise.

>talk
(to Helen)
Are you trying to ask someone about something? Show someone something? Or tell someone about something?

>ask
(about the fire extinguisher)
(addressing Helen)
There is no reply.

>ask about the fire extinguisher
There is no reply.

>tell
(Helen about the fire extinguisher)
There is no reply.

>tell about fire extinguisher
You can't see any such thing.

* * *

>ask
(about the fire extinguisher)
There's no one here to talk to.

>track responses
Now tracking responses. Type "track off" to disable.

>play game
You launch the game.

But before you get to the point of continuing your most recent campaign, something in your computer flashes, blinding you with bright golden light. Then you realize you're not alone anymore. A woman crashes upon you.

And if she were slender a maiden in distress, all should have been well, but this gigantic monster of a lady is in full medival armor when she lands on your head.

You are about to scream in pain. You are about to fight or flight because this is New York City, and having a stranger appearing in your place out of a sudden is a bad sign.

>ask why she is here
[You can't see any such thing. - type "response 1" for details]

>response 1
parser error internal rule response (E)

Currently:
"[We] [can't] see any such thing."

To change, copy and pase the following line into your source:
The parser error internal rule response (E) is "New response text."

* Note: if this response was defined in your own source text, of course, it's easier to change it by searching for the text in your project and updating the original.

* * *

>ask her about sword
(Helen about the sword)
"Why are you even carrying a sword?" you ask, still fearing for your head.

The armor lady gives you the look like you're stupid, "Because I am a knight, and I am not taking off the sword my lady bestowed me when I was knighted."

Maybe this woman is an actress because that is so method.

* * *

>check fighting
You can't see any such thing.

>test fighting
(Testing.)

>[1] launch game
You launch the game.

But before you get to the point of continuing your most recent campaign, something in your computer flashes, blinding you with bright golden light. Then you realize you're not alone anymore. A woman crashes upon you.

And if she were slender a maiden in distress, all should have been well, but this gigantic monster of a lady is in full Medival armor when she lands on your head.

You are about to scream in pain. You are about to fight or flight because this is New York City, and having a stranger appearing in your place out of a sudden is a bad sign.

>[2] fight woman
Violence isn't the answer to this one.

>[3] fight her with pc
(Helen with the PC)
You aren't going to punch some armor with your bare hands, are you?

>[4] fight her with fire extinguisher
(Helen with the fire extinguisher)
You aren't going to punch some armor with your bare hands, are you?

>fight
"What in the fuck is going on?! Why the fuck are you in my room?!" you curse and kick into the woman's abdomen.

But that proves to be a horrible idea because of the way she is covered by heavy armor from head to toe. Not only your head hurts, but your foot hurts, too.

For someone covered in so much weight, the woman is still faster than you, and she easily tackles you to the ground. You think you're getting killed, but is there something in the room that is also made of metal? Maybe you can fight her with it?

* * *

>launch game
You launch the game.

But before you get to the point of continuing your most recent campaign, something in your computer flashes, blinding you with bright golden light. Then you realize you're not alone anymore. A woman crashes upon you.

And if she were slender a maiden in distress, all should have been well, but this gigantic monster of a lady is in full Medival armor when she lands on your head.

You are about to scream in pain. You are about to fight or flight because this is New York City, and having a stranger appearing in your place out of a sudden is a bad sign.

>ask about sword
(addressing Helen)
Since you know nothing about medieval stuff and have absolutely no clue what to ask about, maybe examine that thing first just to avoid sounding like an idiot?

>scream
You scream because your head hurts like hell. Because Why the heck is this person in your room?

"My sincerest apologies, my lady," the woman quickly picks her up and bows her head. "Are you injured?"

>no
"Of course I'm fine! I'm a real man!" you groan despite how much your head groans.

Helen frowns, sizing you up, "A man? Huh." If she's trying to stay polite you don't know, but the questioning in her look is pretty obvious to you.

What the heck does that mean? You are about to protest, but the moment you notice the giant sword she carries, all curses are swallowed back down. Hell, you'd pretty much like your head to stay on your shoulders.

>ask about wrod
Since you know nothing about medieval stuff and have absolutely no clue what to ask about, maybe examine that thing first just to avoid sounding like an idiot?

>ask about sword
Since you know nothing about medieval stuff and have absolutely no clue what to ask about, maybe examine that thing first just to avoid sounding like an idiot?

>ask her about sword
(Helen about that)
Since you know nothing about medieval stuff and have absolutely no clue what to ask about, maybe examine that thing first just to avoid sounding like an idiot?

* * *

>ask about sword
(addressing Helen)
Since you know nothing about medieval stuff and have absolutely no clue what to ask about, maybe examine that thing first just to avoid sounding like an idiot?

>x sword
The sword, though perfectly sheathed into the golden, well, sheath, proudly displays a family crest that you are too familiar with. The crest of House Saegaria, the very royal family in Assault on Saegaria that you are trying to defeat.

>ask about sword
"Why are you even carrying a sword?" you ask, still fearing for your head.

Helen gives you the look like you're stupid, "Because I am a knight, and I am not taking off the sword my lady bestowed me when I was knighted."

Maybe this woman is an actress because that is so method.

>track responses
Now tracking responses. Type "track off" to disable.

>ask about armor
[There is no reply. - type "response 1" for details]

>response 1
block asking rule response (A)

Currently:
"[There] [are] no reply."

To change, copy and pase the following line into your source:
The block asking rule response (A) is "New response text."

* Note: if this response was defined in your own source text, of course, it's easier to change it by searching for the text in your project and updating the original.

* * *

>launch game
You launch the game.

But before you get to the point of continuing your most recent campaign, something in your computer flashes, blinding you with bright golden light. Then you realize you're not alone anymore. A woman crashes upon you.

And if she were slender a maiden in distress, all should have been well, but this gigantic monster of a lady is in full Medival armor when she lands on your head.

You are about to scream in pain. You are about to fight or flight because this is New York City, and having a stranger appearing in your place out of a sudden is a bad sign.

>ask her about sword
(Helen about that)
There is no reply.

>x sword
The sword, though perfectly sheathed into the golden, well, sheath, proudly displays a family crest that you are too familiar with. The crest of House Saegaria, the very royal family in Assault on Saegaria that you are trying to defeat.

The sword is currently switched off.

>ask her about sword
(Helen about the sword)
"Why are you even carrying a sword?" you ask, still fearing for your head.

Helen gives you the look like you're stupid, "Because I am a knight, and I am not taking off the sword my lady bestowed me when I was knighted."

Maybe this woman is an actress because that is so method.

* * *

>launch game
You launch the game.

But before you get to the point of continuing your most recent campaign, something in your computer flashes, blinding you with bright golden light. Then you realize you're not alone anymore. A woman crashes upon you.

And if she were slender a maiden in distress, all should have been well, but this gigantic monster of a lady is in full Medival armor when she lands on your head.

You are about to scream in pain. You are about to fight or flight because this is New York City, and having a stranger appearing in your place out of a sudden is a bad sign.

>fight
"What in the fuck is going on?! Why the fuck are you in my room?!" you curse and kick into the woman's abdomen.

But that proves to be a horrible idea because of the way she is covered by heavy armor from head to toe. Not only your head hurts, but your foot hurts, too.

For someone covered in so much weight, the woman is still faster than you, and she easily tackles you to the ground. You think you're getting killed, but is there something in the room that is also made of metal? Maybe you can fight her with it?

>fight her
(Helen)
Try "fight" or "fight someone with something" instead.

>fight armor lady with gun
You aren't going to punch some armor with your bare hands, are you?

>take fire extinguisher
Taken.

>fight her with gun
(Helen with the gun)
Shooting someone without a gun permit will get you into big trouble.

>fight her with fire extinguisher
(Helen with the fire extinguisher)
You fight the mysterious armor lady with the fire extinguisher, and manage to knock her back a few steps.

* * *

>launch game
You launch the game.

But before you get to the point of continuing your most recent campaign, something in your computer flashes, blinding you with bright golden light. Then you realize you're not alone anymore. A woman crashes upon you.

And if she were slender a maiden in distress, all should have been well, but this gigantic monster of a lady is in full Medival armor when she lands on your head.

You are about to scream in pain. You are about to fight or flight because this is New York City, and having a stranger appearing in your place out of a sudden is a bad sign.

>fight woman
Violence isn't the answer to this one.

>fight helen
Violence isn't the answer to this one.

* * *

>fight woman
Violence isn't the answer to this one.

>x fire extinguisher
You can't see any such thing.

>l
Apartment
A shitty studio apartment, but it's a cozy kind of shitty--tiny but full of warmth, old but full of character. You like it because it's your apartment. 

You have a gamer PC in front of you. Playing Assault on Saegaria has been your routine, and you don't plan to break it tonight.

You can see a fire extinguisher here.

* * *

>launch game
You launch the game.

But before you get to the point of continuing your most recent campaign, something in your computer flashes, blinding you with bright golden light. Then you realize you're not alone anymore. A woman crashes upon you.

And if she were slender a maiden in distress, all should have been well, but this gigantic monster of a lady is in full Medival armor when she lands on your head.

You are about to scream in pain. You are about to fight or flight because this is New York City, and having a stranger appearing in your place out of a sudden is a bad sign.

>l
Apartment
A shitty studio apartment, but it's a cozy kind of shitty--tiny but full of warmth, old but full of character. You like it because it's your apartment. 

You have a gamer PC in front of you. Playing Assault on Saegaria has been your routine, and you don't plan to break it tonight.

* * *

>launch game
You launch the game.

But before you get to the point of continuing your most recent campaign, something in your computer flashes, blinding you with bright golden light. Then you realize you're not alone anymore. A woman crashes upon you.

And if she were slender a maiden in distress, all should have been well, but this gigantic monster of a lady is in full Medival armor when she lands on your head.

You are about to scream in pain. You are about to fight or flight because this is New York City, and having a stranger appearing in your place out of a sudden is a bad sign.

>scream
You scream because your head hurts like hell. Because Why the heck is this person in your room?

"My sincerest apologies, my lady," the woman quickly picks her up and bows her head. "Are you injured?"

>no
"Of course I'm fine! I'm a real man!" you groan despite how much your head groans.

Helen frowns, sizing you up, "A man? Huh." If she's trying to stay polite you don't know, but the questioning in her look is pretty obvious to you.

What the heck does that mean? You are about to protest, but the moment you notices the giant sword she carries, all curses are swallowed back down. Hell, you'd pretty much like your head to stay on your shoulders.

>scream
You scream because your head hurts like hell. Because Why the heck is this person in your room?

"My sincerest apologies, my lady," the woman quickly picks her up and bows her head. "Are you injured?"

>yes
"Just gimme a sec. My head just... ugh, hurts really bad," you groan. "And mind you, I am a man.

Helen frowns, sizing you up, "A man? Huh." If she's trying to stay polite you don't know, but the questioning in her look is pretty obvious to you.

What the heck does that mean? You are about to protest, but the moment you notice the giant sword she carries, all curses are swallowed back down. Hell, you'd pretty much like your head to stay on your shoulders.

>ask about sword
(addressing Helen)
There is no reply.

* * *

>launch game
You launch the game.

But before you get to the point of continuing your most recent campaign, something in your computer flashes, blinding you with bright golden light. Then you realize you're not alone anymore. A woman crashes upon you.

And if she were slender a maiden in distress, all should have been well, but this gigantic monster of a lady is in full Medival armor when she lands on your head.

You are about to scream in pain. You are about to fight or flight because this is New York City, and having a stranger appearing in your place out of a sudden is a bad sign.

>take armor
You are too scared of the lady to steal things from her.

>take sword
You are too scared of the lady to steal things from her.

>ask about sword
(addressing Helen)
There is no reply.

>ask her about sword
(Helen about that)
There is no reply.

* * *

>take armor
You are too scared of the lady to steal things from her.

>x armor
Somehow, you think you've seen this armor before. 

Shiny, silver, with the shinest possible metal--the kind of expensive stuff that no one should be able to afford--modern cosplayers and real medieval soldiers alike.

You can't help but wonder about this woman's identity. But unless her dad is Elon Musk and bought her this ridiculous set of armor, you can't think of another explanation.

>ask about sword
(addressing Helen)
There is no reply.

>x helen
You see nothing special about Helen.

* * *

>launch game
You launch the game.

But before you get to the point of continuing your most recent campaign, something in your computer flashes, blinding you with bright golden light. Then you realize you're not alone anymore. A woman crashes upon you.

And if she were slender a maiden in distress, all should have been well, but this gigantic monster of a lady is in full Medival armor when she lands on your head.

You are about to scream in pain. You are about to fight or flight because this is New York City, and having a stranger appearing in your place out of a sudden is a bad sign.

>talk to helen
You say hello to Helen.

* * *

>look at fire extinguisher
You bought it not just so your renter's insurance could be cheaper, but this would serve as a good weapon as well if somebody decided to break in. This is New York City after all.

>look around
You can't see any such thing.

>look
Apartment
A shitty studio apartment, but it's a cozy kind of shitty--tiny but full of warmth, old but full of character. You like it because it's your apartment. 

You have a gamer PC in front of you. Playing Assault on Saegaria has been your routine, and you don't plan to break it tonight.

You haven't launched the game yet.

You can see a fire extinguisher here.

>look at PC
Expensive machine. It's sole purpose is only for the game, Assault on Saegaria.

>play game
You launch the game.

But before you get to the point of continuing your most recent campaign, something in your computer flashes, blinding you with bright golden light. Then you realize you're not alone anymore. A woman crashes upon you.

And if she were slender a maiden in distress, all should have been well, but this gigantic monster of a lady is in full medival armor when she lands on your head.

You are about to scream in pain. You are about to fight or flight because this is New York City, and having a stranger appearing in your place out of a sudden is a bad sign.

>say hello
(addressing Helen)
You say hello to Helen.

>say whats up
(to Helen)
There is no reply.

>look at woman
She is wearing some really fancy armor and sword.

>check armor
Somehow, you think you've seen this armor before. 

Shiny, silver, with the shinest possible metal--the kind of expensive stuff that no one should be able to afford--modern cosplayers and real medieval soldiers alike.

You can't help but wonder about this woman's identity. But unless her dad is Elon Musk and bought her this ridiculous set of armor, you can't think of another explanation.

>play game
The game already launched.

>ask helen to leave
I didn't understand that sentence.

>say leave
(to Helen)
There is no reply.

>ask what are you doing here
You can't see any such thing.

>say what are you doing here
(to Helen)
There is no reply.

>check sword
The sword, though perfectly sheathed into the golden, well, sheath, proudly displays a family crest that you are too familiar with. The crest of House Saegaria, the very royal family in Assault on Saegaria that you are trying to defeat.

>take sword
You are too scared of the lady to steal things from her.

>scream
You scream because your head hurts like hell. Because Why the heck is this person in your room?

"My sincerest apologies, my lady," the woman quickly picks her up and bows her head. "Are you injured?"

* * *

>no
"Of course I'm fine! I'm a real man!" you groan despite how much your head groans.

Helen frowns, sizing you up, "A man? Huh." If she's trying to stay polite you don't know, but the questioning in her look is pretty obvious to you.

What the heck does that mean? You are about to protest, but the moment you notice the giant sword she carries, all curses are swallowed back down. Hell, you'd pretty much like your head to stay on your shoulders.

>yes
That was a rhetorical question.

>ok
That's not a verb I recognise.

>protest
That's not a verb I recognise.

>what are you doing here
That's not a verb I recognise.

>say what are you doing here
(to Helen)
There is no reply.

>say leave
(to Helen)
There is no reply.

>help
That's not a verb I recognise.

>ask about man
There is no reply.

>leave
But you aren't in anything at the moment.

>go outside
You can't go that way.

>ask about origin
There is no reply.

>ask about sword
"Why are you even carrying a sword?" you ask, still fearing for your head.

The armor lady gives you the look like you're stupid, "Because I am a knight, and I am not taking off the sword my lady bestowed me when I was knighted."

Maybe this woman is an actress because that is so method. What is her real identity, then?

>ask about armor
"Did you just get out of a cosplay event? That is some impressive armor. Did you get them from Etsy?" you tell her. If there is one in town right now, you definitely are going.

"Pardon me, but I do not understand what a "cosplay" is, nor do I know about "Ezzie". Is that perhaps the title of a lord? These armors belong to the royal family of Saegaria and the Order of the Knights of Sun."

She's either too into the whole cosplay thing, or she is totally nuts. You wonder about her identity.

>ask about identity
"Who are you? Why are you in my room?" You grumble.

"Oh sweet goddess, where are my manners?" the woman bows again. "Helen of Saegaria, champion and personal knight to Her Royal Highness, Princess Josephine. It is a pleasure to make you acquaintance."

What in the-- You blink, and blink again. The princess' knight, the final boss you fought and died countless times, is a woman.

But how did she get here? The important question: why is she here?

>ask why she is here
You can't see any such thing.

>ask shy she is here
You can't see any such thing.

* * *

>look at fire extinguisher
You bought it not just so your renter's insurance could be cheaper, but this would serve as a good weapon as well if somebody decided to break in. This is New York City after all.

>shitty apartment
That's not a verb I recognise.

>playing
That's not a verb I recognise.

>playing the game
That's not a verb I recognise.

>play game
You launch the game.

But before you get to the point of continuing your most recent campaign, something in your computer flashes, blinding you with bright golden light. Then you realize you're not alone anymore. A woman crashes upon you.

And if she were slender a maiden in distress, all should have been well, but this gigantic monster of a lady is in full medival armor when she lands on your head.

You are about to scream in pain. You are about to fight or flight because this is New York City, and having a stranger appearing in your place out of a sudden is a bad sign.

>scream in pain
I only understood you as far as wanting to scream.

>scream
You scream because your head hurts like hell. Because Why the heck is this person in your room?

"My sincerest apologies, my lady," the woman quickly picks her up and bows her head. "Are you injured?"

Please answer yes or no.

>yes
"Just gimme a sec. My head just... ugh, hurts really bad," you groan. "And mind you, I am a man.

Helen frowns, sizing you up, "A man? Huh." If she's trying to stay polite you don't know, but the questioning in her look is pretty obvious to you.

What the heck does that mean? You are about to protest, but the moment you notice the giant sword she carries, all curses are swallowed back down. Hell, you'd pretty much like your head to stay on your shoulders.

>ask
(about the fire extinguisher)
(addressing Helen)
There is no reply.

>question
That's not a verb I recognise.

>protest
That's not a verb I recognise.

>curse
That's not a verb I recognise.

>examine sword
The sword, though perfectly sheathed into the golden, well, sheath, proudly displays a family crest that you are too familiar with. The crest of House Saegaria, the very royal family in Assault on Saegaria that you are trying to defeat.

>ask about family crest
"I serve the royal family of Saegaria, and only the most trusted allies of the royal family shall bear their crest," the armor lady says proudly.

That is some weird reaction to a simple question. Just who is her?

>Ask who she is
You can't see any such thing.

>Ask somebody something
You can't see any such thing.

>Ask her something
I didn't understand that sentence.

>Ask her who she is
I didn't understand that sentence.

>Ask who is she
You can't see any such thing.

* * *

>play game
You launch the game.

But before you get to the point of continuing your most recent campaign, something in your computer flashes, blinding you with bright golden light. Then you realize you're not alone anymore. A woman crashes upon you.

And if she were slender a maiden in distress, all should have been well, but this gigantic monster of a lady is in full medival armor when she lands on your head.

You are about to scream in pain. You are about to fight or flight because this is New York City, and having a stranger appearing in your place out of a sudden is a bad sign.

>Show helen the game
(first taking the Assault on Saegaria)
Helen is unimpressed.

>i
You are carrying:
  an Assault on Saegaria

* * *

>play game
You launch the game.

But before you get to the point of continuing your most recent campaign, something in your computer flashes, blinding you with bright golden light. Then you realize you're not alone anymore. A woman crashes upon you.

And if she were slender a maiden in distress, all should have been well, but this gigantic monster of a lady is in full medival armor when she lands on your head.

You are about to scream in pain. You are about to fight or flight because this is New York City, and having a stranger appearing in your place out of a sudden is a bad sign.

>ask about knight orer
(addressing Helen)
There is no reply.

>ask her about knight order
(Helen about the Order of the Knights of Sun)
"It is the most prestigious knight order in the world," she frowns. "Do you not know about its name? Curious."

* * *

>play game
You launch the game.

But before you get to the point of continuing your most recent campaign, something in your computer flashes, blinding you with bright golden light. Then you realize you're not alone anymore. A woman crashes upon you.

And if she were slender a maiden in distress, all should have been well, but this gigantic monster of a lady is in full medival armor when she lands on your head.

You are about to scream in pain. You are about to fight or flight because this is New York City, and having a stranger appearing in your place out of a sudden is a bad sign.

>ask about why she is here
(addressing Helen)
"Holy shit," you are amazed, "holy shit. You're the final boss in Assault on Saegaria. How did you get here?!"

Helen wrinkles her nose hearing your use of language, "What are you talking about? Not only your logic baffles me but that foul language of yours."

"No, but you are the most famous and infamous character in this game!

"A game?" Helen is clearly ruffled. "Are you declaring that my honor and my service to the crown is nothing but a game to you?"

You begin to realize Helen will not understand or believe you without showing her any concrete proof.

>ask why she is here
You can't see any such thing.

* * *

>play game
You launch the game.

But before you get to the point of continuing your most recent campaign, something in your computer flashes, blinding you with bright golden light. Then you realize you're not alone anymore. A woman crashes upon you.

And if she were slender a maiden in distress, all should have been well, but this gigantic monster of a lady is in full medival armor when she lands on your head.

You are about to scream in pain. You are about to fight or flight because this is New York City, and having a stranger appearing in your place out of a sudden is a bad sign.

>ask helen about the sword
There is no reply.

>look
Apartment
A shitty studio apartment, but it's a cozy kind of shitty--tiny but full of warmth, old but full of character. You like it because it's your apartment. 

You have a gamer PC in front of you. Playing Assault on Saegaria has been your routine, and you don't plan to break it tonight.

You can see a fire extinguisher here.

>talk to helen
Are you trying to ask someone about something? Show someone something? Or tell someone about something?

>tell helen about sword
There is no reply.

>look
Apartment
A shitty studio apartment, but it's a cozy kind of shitty--tiny but full of warmth, old but full of character. You like it because it's your apartment. 

You have a gamer PC in front of you. Playing Assault on Saegaria has been your routine, and you don't plan to break it tonight.

You can see a fire extinguisher here.

>ask helen about herself
"Who are you? Why are you in my room?" You grumble.

"Oh sweet goddess, where are my manners?" the woman bows again. "Helen of Saegaria, champion and personal knight to Her Royal Highness, Princess Josephine. It is a pleasure to make you acquaintance."

What in the-- You blink, and blink again. The princess' knight, your future final boss, is a woman.

But how did she get here?

* * *

>ask helen about the sword
There is no reply.

>x maiden
You can't see any such thing.

>x her
(Helen)
She is wearing some really fancy armor and sword.

>ask helen about sword
There is no reply.

>ask helen about armor
There is no reply.

>x armor
Somehow, you think you've seen this armor before. 

Shiny, silver, with the shinest possible metal--the kind of expensive stuff that no one should be able to afford--modern cosplayers and real medieval soldiers alike.

You can't help but wonder about this woman's identity. But unless her dad is Elon Musk and bought her this ridiculous set of armor, you can't think of another explanation.

>x sword
The sword, though perfectly sheathed into the golden, well, sheath, proudly displays a family crest that you are too familiar with. The crest of House Saegaria, the very royal family in Assault on Saegaria that you are trying to defeat.

The sword is currently switched off.

>ask sword
You can only do that to something animate.

>ask helen about sword
"Why are you even carrying a sword?" you ask, still fearing for your head.

Helen gives you the look like you're stupid, "Because I am a knight, and I am not taking off the sword my lady bestowed me when I was knighted."

Maybe this woman is an actress because that is so method.

* * *

>play game
You launch the game.

But before you get to the point of continuing your most recent campaign, something in your computer flashes, blinding you with bright golden light. Then you realize you're not alone anymore. A woman crashes upon you.

And if she were slender a maiden in distress, all should have been well, but this gigantic monster of a lady is in full medival armor when she lands on your head.

You are about to scream in pain. You are about to fight or flight because this is New York City, and having a stranger appearing in your place out of a sudden is a bad sign.

>ask helen about why she is here
"Holy shit," you are amazed, "holy shit. You're the final boss in Assault on Saegaria. How did you get here?!"

Helen wrinkles her nose hearing your use of language, "What are you talking about? Not only your logic baffles me but that foul language of yours."

"No, but you are the most famous and infamous character in this game!

"A game?" Helen is clearly ruffled. "Are you declaring that my honor and my service to the crown is nothing but a game to you?"

You begin to realize Helen will not understand or believe you without showing her any concrete proof.

>ask her about why she is here
(Helen about Why-she-is-here)
"Holy shit," you are amazed, "holy shit. You're the final boss in Assault on Saegaria. How did you get here?!"

Helen wrinkles her nose hearing your use of language, "What are you talking about? Not only your logic baffles me but that foul language of yours."

"No, but you are the most famous and infamous character in this game!

"A game?" Helen is clearly ruffled. "Are you declaring that my honor and my service to the crown is nothing but a game to you?"

You begin to realize Helen will not understand or believe you without showing her any concrete proof.

* * *

>play game
You launch the game.

But before you get to the point of continuing your most recent campaign, something in your computer flashes, blinding you with bright golden light. Then you realize you're not alone anymore. A woman crashes upon you.

And if she were slender a maiden in distress, all should have been well, but this gigantic monster of a lady is in full medival armor when she lands on your head.

You are about to scream in pain. You are about to fight or flight because this is New York City, and having a stranger appearing in your place out of a sudden is a bad sign.

>ask her about armor
(Helen about that)
There is no reply.

>x armor
Somehow, you think you've seen this armor before. 

Shiny, silver, with the shinest possible metal--the kind of expensive stuff that no one should be able to afford--modern cosplayers and real medieval soldiers alike.

You can't help but wonder about this woman's identity. But unless her dad is Elon Musk and bought her this ridiculous set of armor, you can't think of another explanation.

>ask her about armor
(Helen about the armor)
"Did you just get out of a cosplay event? That is some impressive armor. Did you get them from Etsy?" you tell her. If there is one in town right now, you definitely are going.

"Pardon me, but I do not understand what a "cosplay" is, nor do I know about "Ezzie". Is that perhaps the title of a lord? These armors belong to the royal family of Saegaria and the Order of the Knights of Sun."

She's either too into the whole game, or she is nuts.

>ask her about sword
(Helen about that)
There is no reply.

* * *

>play game
You launch the game.

But before you get to the point of continuing your most recent campaign, something in your computer flashes, blinding you with bright golden light. Then you realize you're not alone anymore. A woman crashes upon you.

And if she were slender a maiden in distress, all should have been well, but this gigantic monster of a lady is in full medival armor when she lands on your head.

You are about to scream in pain. You are about to fight or flight because this is New York City, and having a stranger appearing in your place out of a sudden is a bad sign.

>ask her about sword
(Helen about that)
There is no reply.

>ask her about sword
(Helen about that)
There is no reply.

* * *

>play game
You launch the game.

But before you get to the point of continuing your most recent campaign, something in your computer flashes, blinding you with bright golden light. Then you realize you're not alone anymore. A woman crashes upon you.

And if she were slender a maiden in distress, all should have been well, but this gigantic monster of a lady is in full medival armor when she lands on your head.

You are about to scream in pain. You are about to fight or flight because this is New York City, and having a stranger appearing in your place out of a sudden is a bad sign.

>ask why she is here
Hint: Try "asking about" something.

>asking about why she is here
That's not a verb I recognise.

>ask about why she is here
(addressing Helen)
"Holy shit," you are amazed, "holy shit. You're the final boss in Assault on Saegaria. How did you get here?!"

Helen wrinkles her nose hearing your use of language, "What are you talking about? Not only your logic baffles me but that foul language of yours."

"No, but you are the most famous and infamous character in this game!

"A game?" Helen is clearly ruffled. "Are you declaring that my honor and my service to the crown is nothing but a game to you?"

You begin to realize Helen will not understand or believe you without showing her any concrete proof.

* * *

>play game
You launch the game.

But before you get to the point of continuing your most recent campaign, something in your computer flashes, blinding you with bright golden light. Then you realize you're not alone anymore. A woman crashes upon you.

And if she were slender a maiden in distress, all should have been well, but this gigantic monster of a lady is in full medival armor when she lands on your head.

You are about to scream in pain. You are about to fight or flight because this is New York City, and having a stranger appearing in your place out of a sudden is a bad sign.

>l
Apartment
A shitty studio apartment, but it's a cozy kind of shitty--tiny but full of warmth, old but full of character. You like it because it's your apartment. 

You have a gamer PC in front of you. Playing Assault on Saegaria has been your routine, and you don't plan to break it tonight.

The game is running.

You can see a fire extinguisher here.

* * *

>play game
You launch the game.

But before you get to the point of continuing your most recent campaign, something in your computer flashes, blinding you with bright golden light. Then you realize you're not alone anymore. A woman crashes upon you.

And if she were slender a maiden in distress, all should have been well, but this gigantic monster of a lady is in full medival armor when she lands on your head.

You are about to scream in pain. You are about to fight or flight because this is New York City, and having a stranger appearing in your place out of a sudden is a bad sign.

>show helen fire extinguisher
You haven't even figured out who this lady is and you're talking about the fire extinguisher? Real cool, bro.

* * *

>play game
You launch the game.

But before you get to the point of continuing your most recent campaign, something in your computer flashes, blinding you with bright golden light. Then you realize you're not alone anymore. A woman crashes upon you.

And if she were slender a maiden in distress, all should have been well, but this gigantic monster of a lady is in full medival armor when she lands on your head.

You are about to scream in pain. You are about to fight or flight because this is New York City, and having a stranger appearing in your place out of a sudden is a bad sign.

>show her excel sheet
(to Helen)
How pathetic are you, showing somebody your precious little accounting excel sheets? Also, aren't you under NDA?

>show her the fire extinguisher
(to Helen)
You haven't even figured out who this lady is and you're talking about the fire extinguisher? Real cool, bro.

>ask identity
Hint: Try "ask about" something.

>ask about identity
"Who are you? Why are you in my room?" You grumble.

"Oh sweet goddess, where are my manners?" the woman bows again. "Helen of Saegaria, champion and personal knight to Her Royal Highness, Princess Josephine. It is a pleasure to make you acquaintance."

What in the-- You blink, and blink again. The princess' knight, the final boss you fought and died countless times, is a woman.

But how did she get here? The important question: why is she here?

>show excel sheet
(to Helen)
How pathetic are you, showing somebody your precious little accounting excel sheets? Also, aren't you under NDA?

>show game
(to Helen)
(first taking the Assault on Saegaria)
Helen is unimpressed.

>show fire extinguisher
(to Helen)
You show Helen the fire extinguisher, though you have no idea why you want to do that.

"So what weapon is this?" Helen examines it closely. "Good metal work. It is going to be useful in a battle."

"We, ugh, extinguish fire with this," you say haltingly, realizing how dumb you sound.

"Like putting out the fire and rage of a war? I am not one familiar with literary metaphors. They are for the lords and ladies," Helen shakes her head.

Maybe talking about the fire extinguisher isn't fruitful in this situation."

* * *

>play game
You launch the game.

But before you get to the point of continuing your most recent campaign, something in your computer flashes, blinding you with bright golden light. Then you realize you're not alone anymore. A woman crashes upon you.

And if she were slender a maiden in distress, all should have been well, but this gigantic monster of a lady is in full medival armor when she lands on your head.

You are about to scream in pain. You are about to fight or flight because this is New York City, and having a stranger appearing in your place out of a sudden is a bad sign.

>show her fire extinguisher
(to Helen)
(first taking the fire extinguisher)
Helen is unimpressed.

>show helen the fire extinguisher
Helen is unimpressed.

>x fire extinguisher
You bought it not just so your renter's insurance could be cheaper, but this would serve as a good weapon as well if somebody decided to break in. This is New York City after all.

>show her fire extinguisher
(to Helen)
Helen is unimpressed.

>i
You are carrying:
  a fire extinguisher

>show helen the armor
(first taking the armor)
You are too scared of the lady to steal things from her.

>show helen princess
You can't see any such thing.

* * *

>play game
You launch the game.

But before you get to the point of continuing your most recent campaign, something in your computer flashes, blinding you with bright golden light. Then you realize you're not alone anymore. A woman crashes upon you.

And if she were slender a maiden in distress, all should have been well, but this gigantic monster of a lady is in full medival armor when she lands on your head.

You are about to scream in pain. You are about to fight or flight because this is New York City, and having a stranger appearing in your place out of a sudden is a bad sign.

>take sword
You are too scared of the lady to steal things from her.

>x sword
The sword, though perfectly sheathed into the golden, well, sheath, proudly displays a family crest that you are too familiar with. The crest of House Saegaria, the very royal family in Assault on Saegaria that you are trying to defeat.

* * *

>ponder about sword
That's not a verb I recognise.

>think about sword
You have no thoughts on that subject right now.

>test me
(Testing.)

>[1] launch game
You launch the game.

But before you get to the point of continuing your most recent campaign, something in your computer flashes, blinding you with bright golden light. Then you realize you're not alone anymore. A woman crashes upon you.

And if she were slender a maiden in distress, all should have been well, but this gigantic monster of a lady is in full Medival armor when she lands on your head.

You are about to scream in pain. You are about to curse because what in the holy macaroni is going on?

>[2] scream
You scream because your head hurts like hell. Because Why the heck is this person in your room?

"My sincerest apologies, my lady," the woman quickly picks her up and bows her head. "Are you injured?"
[3] yes
"Just gimme a sec. My head just... ugh, hurts really bad," you groan. "And mind you, I am a man.

Helen frowns, sizing you up, "A man? Huh." If she's trying to stay polite you don't know, but the questioning in her look is pretty obvious to you.

What the heck does that mean? You are about to protest, but the moment you notices the giant sword she carries, all curses are swallowed back down. Hell, you'd pretty much like your head to stay on your shoulders.

>think about sowrd
You have no thoughts on that subject right now.

>x sword
The sword, though perfectly sheathed into the golden, well, sheath, proudly displays a family crest that you are too familiar with. The crest of House Saegaria, the very royal family in Assault on Saegaria that you are trying to defeat.

* * *

>take armor
You can't see any such thing.

>launch game
You launch the game.

But before you get to the point of continuing your most recent campaign, something in your computer flashes, blinding you with bright golden light. Then you realize you're not alone anymore. A woman crashes upon you.

And if she were slender a maiden in distress, all should have been well, but this gigantic monster of a lady is in full Medival armor when she lands on your head.

You are about to scream in pain. You are about to fight or flight because this is New York City, and having a stranger appearing in your place out of a sudden is a bad sign.

>take armor
You can't see any such thing.

* * *

>talk to Helen
You can't see any such thing.

>launch game
You launch the game.

But before you get to the point of continuing your most recent campaign, something in your computer flashes, blinding you with bright golden light. Then you realize you're not alone anymore. A woman crashes upon you.

And if she were slender a maiden in distress, all should have been well, but this gigantic monster of a lady is in full Medival armor when she lands on your head.

You are about to scream in pain. You are about to curse because what in the holy macaroni is going on?

>talk to helen
You say hello to Helen.

>l
Apartment
A shitty studio apartment, but it's a cozy kind of shitty--tiny but full of warmth, old but full of character. You like it because it's your apartment. 

You have a gamer PC in front of you. Playing Assault on Saegaria has been your routine, and you don't plan to break it tonight.

>x game
Praised as Game of the Year. AAA production, real cool stuff with a bulky white dude with brown hair as the protagonist.Your goal is to take the capital city of Saegaria and snatch the princess from the castle. The final battle with princess" personal knight is considered the toughest boss fight by almost all gamers on the internet.

* * *

>talk to helen
You can't see any such thing.

>launch game
You launch the game.

But before you get to the point of continuing your most recent campaign, something in your computer flashes, blinding you with bright golden light. Then you realize you're not alone anymore. A woman crashes upon you.

And if she were slender a maiden in distress, all should have been well, but this gigantic monster of a lady is in full Medival armor when she lands on your head.

You are about to scream in pain. You are about to curse because what in the holy macaroni is going on?

* * *

>test fightin
>--> The following tests are available:
'test screaming'
'test fighting'

>test fighting
(Testing.)

>[1] launch game
You launch the game.

But before you get to the point of continuing your most recent campaign, something in your computer flashes, blinding you with bright golden light. Then you realize you're not alone anymore. A woman crashes upon you.

And if she were slender a maiden in distress, all should have been well, but this gigantic monster of a lady is in full Medival armor when she lands on your head.

You are about to scream in pain. You are about to fight or flight because this is New York City, and having a stranger appearing in your place out of a sudden is a bad sign.

>[2] fight her
I'm not sure what 'her' refers to.

>[3] fight her with pc
I'm not sure what 'her' refers to.

>[4] fight her with sword
I'm not sure what 'her' refers to.

>[5] fight her with fire extinguisher
I'm not sure what 'her' refers to.

* * *

>test fighting
(Testing.)

>[1] launch game
You launch the game.

But before you get to the point of continuing your most recent campaign, something in your computer flashes, blinding you with bright golden light. Then you realize you're not alone anymore. A woman crashes upon you.

And if she were slender a maiden in distress, all should have been well, but this gigantic monster of a lady is in full Medival armor when she lands on your head.

You are about to scream in pain. You are about to fight or flight because this is New York City, and having a stranger appearing in your place out of a sudden is a bad sign.

>[2] fight
"What in the fuck is going on?! Why the fuck are you in my room?!" you curse and kick into the woman's abdomen.

But that proves to be a horrible idea because of the way she is covered by heavy armor from head to toe. Not only your head hurts, but your foot hurts, too.

For someone covered in so much weight, the woman is still faster than you, and she easily tackles you to the ground. You think you're getting killed, but is there something in the room that is also made of metal? Maybe you can fight her with it?

>[3] fight her with pc
(Helen with the PC)
You aren't going to punch some armor with your bare hands, are you? There is nothing in your inventory!

>[4] take fire extinguisher
Taken.

>[5] fight her with fire extinguisher
(Helen with the fire extinguisher)
You slam the fire extinguisher into her metal chest plate, knocking her back a few steps. But just as the armor lady picks herself up, you notice the giant sword she carries, all curses are swallowed back down.

"I mean no harm, and hell, look at me! How in the heaven's name could I even harm you?" you gesticulate at your whole body, which is as skinny and frail as any other accountant's on Wall Street.

"All right. I may not attack an enemy who yields." the armor lady says with a frown. Her armor still immaculate without any scratches.

>[6] ask about sword
(addressing Helen)
There is no reply.

>[7] ask about armor
There is no reply.

>[8] ask about identity
"Who are you? Why are you in my room?" You grumble.

"Oh sweet goddess, where are my manners?" the woman bows again. "Helen of Saegaria, champion and personal knight to Her Royal Highness, Princess Josephine. It is a pleasure to make you acquaintance."

What in the-- You blink, and blink again. The princess' knight, your future final boss, is a woman.

But how did she get here?

>[9] ask helen about why she is here
To be continued.

>ask her about armor
(Helen about that)
There is no reply.

>track responses
Now tracking responses. Type "track off" to disable.

>ask her about armor
(Helen about [that - type "response 1" for details])
[There is no reply. - response 2]

>restart
[Are you sure you want to restart?  - type "response 1" for details]

>yes
Helen of Saegaria
An Interactive Fiction by Diane Wang
Release 1 / Serial number 231025 / Inform 7 v10.1.2 / D

Apartment
A shitty studio apartment, but it's a cozy kind of shitty--tiny but full of warmth, old but full of character. You like it because it's your apartment. 

It's a good thing you still have a place to return to after a day of dull work typing in numbers in an excel sheet. You're glad that you took accounting in college, because though it sucks, it now provides a roof over your head, food to fill your belly, and most importantly, a beefy laptop that allows you to play the latest game, Assault on Saegaria.

Playing that game has been your routine, and you don't plan to break it tonight. 

You can see a fire extinguisher here.

>track responses
Now tracking responses. Type "track off" to disable.

* * *

>fight helen
Violence isn't the answer to this one.

* * *

>fight her with fire extinguisher
You can't see any such thing.

>look
Apartment
A shitty studio apartment, but it's a cozy kind of shitty--tiny but full of warmth, old but full of character. You like it because it's your apartment. 

You have a gamer PC in front of you. Playing Assault on Saegaria has been your routine, and you don't plan to break it tonight.

You can see a fire extinguisher here.

* * *

>ask why she is here
You can't see any such thing.

>ask Helen about why she is here
To be continued.

* * *

>ask woman about identity
There is no reply.

* * *

>no
(addressing Helen)
That was a rhetorical question.

* * *

>x armor
Somehow, you think you've seen this armor before. 

Shiny, silver, with the shinest possible metal--the kind of expensive stuff that no one should be able to afford--modern cosplayers and real medieval soldiers alike.

You can't help but wonder about this woman's identity. But unless her dad is Elon Musk and bought her this ridiculous set of armor, you can't think of another explanation.

>wonder about amor
That noun did not make sense in this context.

>wonder about armor
Back in the old days, only nobles could afford such an expensive set of armors. But nobles wouldn't let their daughters fight at all... Maybe you should ask Helen about the armors.

>ask about armor
just about the princess

* * *

>x armor
Somehow, you think you've seen this armor before. 

Shiny, silver, with the shinest possible metal--the kind of expensive stuff that no one should be able to afford--modern cosplayers and real medieval soldiers alike.

You can't help but wonder about this woman's identity. But unless her dad is Elon Musk and bought her this ridiculous set of armor, you can't think of another explanation.

>x helen
You see nothing special about Helen.

>x sword
You see nothing special about the sword.

* * *

>x sword
sword description.

>x armor
armor description.

* * *

>track response
I didn't understand that sentence.

>track responses
Now tracking responses. Type "track off" to disable.

>launch game
You launch the game.

But before you get to the point of continuing your most recent campaign, something in your computer flashes, blinding you with bright golden light. Then you realize you're not alone anymore. A woman crashes upon you.

And if she were slender a maiden in distress, all should have been well, but this gigantic monster of a lady is in full Medival armor when she lands on your head.

You are about to scream in pain. You are about to fight or flight because this is New York City, and having a stranger appearing in your place out of a sudden is a bad sign.

>fight her
[I'm not sure what 'her' refers to. - type "response 1" for details]

>response 1
parser error internal rule response (J)

Currently:
"I'm not sure what ['][pronoun i6 dictionary word]['] refers to."

To change, copy and pase the following line into your source:
The parser error internal rule response (J) is "New response text."

* Note: if this response was defined in your own source text, of course, it's easier to change it by searching for the text in your project and updating the original.

* * *

>track responses
Now tracking responses. Type "track off" to disable.

* * *

>launch game
You launch the game.

But before you get to the point of continuing your most recent campaign, something in your computer flashes, blinding you with bright golden light. Then you realize you're not alone anymore. A woman crashes upon you.

And if she were slender a maiden in distress, all should have been well, but this gigantic monster of a lady is in full Medival armor when she lands on your head.

You are about to scream in pain. You are about to fight or flight because this is New York City, and having a stranger appearing in your place out of a sudden is a bad sign.

>ask about armor
[(addressing Helen) - type "response 1" for details]
[There is no reply. - response 2]

>ask about identity
"Who are you? Why are you in my room?" You grumble.

"Oh sweet goddess, where are my manners?" the woman bows again. "Helen of Saegaria, champion and personal knight to Her Royal Highness, Princess Josephine. It is a pleasure to make you acquaintance."

What in the-- You blink, and blink again. The princess' knight, your future final boss, is a woman.

But how did she get here?

* * *

>launch game
You launch the game.

But before you get to the point of continuing your most recent campaign, something in your computer flashes, blinding you with bright golden light. Then you realize you're not alone anymore. A woman crashes upon you.

And if she were slender a maiden in distress, all should have been well, but this gigantic monster of a lady is in full Medival armor when she lands on your head.

You are about to scream in pain. You are about to fight or flight because this is New York City, and having a stranger appearing in your place out of a sudden is a bad sign.

>ask about sword
[(addressing Helen) - type "response 1" for details]
[There is no reply. - response 2]

>response 2
block asking rule response (A)

Currently:
"[There] [are] no reply."

To change, copy and pase the following line into your source:
The block asking rule response (A) is "New response text."

* Note: if this response was defined in your own source text, of course, it's easier to change it by searching for the text in your project and updating the original.

* * *

>response 1
parser error internal rule response (J)

Currently:
"I'm not sure what ['][pronoun i6 dictionary word]['] refers to."

To change, copy and pase the following line into your source:
The parser error internal rule response (J) is "New response text."

* Note: if this response was defined in your own source text, of course, it's easier to change it by searching for the text in your project and updating the original.

>fight woman
[Violence isn't the answer to this one. - type "response 1" for details]

>response 1
block attacking rule response (A)

Currently:
"Violence [aren't] the answer to this one."

To change, copy and pase the following line into your source:
The block attacking rule response (A) is "New response text."

* * *

>x excel sheet
You absolutely do not want to look at another Excel sheet tonight.

* * *

>x extinguisher
You bought it not just so your renter's insurance could be cheaper, but this would serve as a good weapon as well if somebody decided to break in. This is New York City after all.

>launch game
You launch the game.

But before you get to the point of continuing your most recent campaign, something in your computer flashes, blinding you with bright golden light. Then you realize you're not alone anymore. A woman crashes upon you.

And if she were slender a maiden in distress, all should have been well, but this gigantic monster of a lady is in full Medival armor when she lands on your head.

You are about to scream in pain. You are about to fight or flight because this is New York City, and having a stranger appearing in your place out of a sudden is a bad sign.

>fight her
I'm not sure what 'her' refers to.

>fight woma
You can't see any such thing.

>fight woman
Violence isn't the answer to this one.

* * *

>x fire extinguisher
You see nothing special about the fire extinguisher.

* * *

>x game
Praised as Game of the Year. AAA production, real cool stuff with a bulky white dude with brown hair as the protagonist. Your goal is to take the capital city of Saegaria and snatch the princess from the castle. The final battle with princess' personal knight is considered the toughest boss fight by almost all gamers on the internet.

* * *

>x helen
You can't see any such thing.

>play game
You launch the game.

But before you get to the point of continuing your most recent campaign, something in your computer flashes, blinding you with bright golden light. Then you realize you're not alone anymore. A woman crashes upon you.

And if she were slender a maiden in distress, all should have been well, but this gigantic monster of a lady is in full medival armor when she lands on your head.

You are about to scream in pain. You are about to fight or flight because this is New York City, and having a stranger appearing in your place out of a sudden is a bad sign.

>x helen
She is wearing some really fancy armor and sword.

>ask about armor
(addressing Helen)
"Did you just get out of a cosplay event? That is some impressive armor. Did you get them from Etsy?" you tell her. If there is one in town right now, you definitely are going.

"Pardon me, but I do not understand what a "cosplay" is, nor do I know about "Ezzie". Is that perhaps the title of a lord? These armors belong to the royal family of Saegaria and the Order of the Knights of Sun."

She's either too into the whole cosplay thing, or she is totally nuts.

>think about armor
Back in the old days, only nobles could afford such an expensive set of armors. But nobles wouldn't let their daughters fight at all... And if somebody went all the way to purchase such a flashy set of armors just for cosplay, that is seriously impressive. Maybe you should ask Helen about the armors.

>talk to lady
Are you trying to ask someone about something? Show someone something? Or tell someone about something?

>ask about sword
"Why are you even carrying a sword?" you ask, still fearing for your head.

The armor lady gives you the look like you're stupid, "Because I am a knight, and I am not taking off the sword my lady bestowed me when I was knighted."

Maybe this woman is an actress because that is so method.

>ask about identity
"Who are you? Why are you in my room?" You grumble.

"Oh sweet goddess, where are my manners?" the woman bows again. "Helen of Saegaria, champion and personal knight to Her Royal Highness, Princess Josephine. It is a pleasure to make you acquaintance."

What in the-- You blink, and blink again. The princess' knight, your future final boss, is a woman.

But how did she get here?

>fight
Helen is literally carrying a sword. And why are you trying to fight her now?

>restart
Are you sure you want to restart?

>yes
Helen of Saegaria
An Interactive Fiction by Diane Wang
Release 1 / Serial number 231026 / Inform 7 v10.1.2 / D

Apartment
A shitty studio apartment, but it's a cozy kind of shitty--tiny but full of warmth, old but full of character. You like it because it's your apartment. 

It's a good thing you still have a place to return to after a day of dull work typing in numbers in an excel sheet. You're glad that you took accounting in college, because though it sucks, it now provides a roof over your head, food to fill your belly, and most importantly, a beefy laptop that allows you to play the latest game, Assault on Saegaria.

Playing that game has been your routine, and you don't plan to break it tonight. 

You haven't launched the game yet.

You can see a fire extinguisher here.

>play game
You launch the game.

But before you get to the point of continuing your most recent campaign, something in your computer flashes, blinding you with bright golden light. Then you realize you're not alone anymore. A woman crashes upon you.

And if she were slender a maiden in distress, all should have been well, but this gigantic monster of a lady is in full medival armor when she lands on your head.

You are about to scream in pain. You are about to fight or flight because this is New York City, and having a stranger appearing in your place out of a sudden is a bad sign.

>x maiden
You can't see any such thing.

>ask her about knight order
(Helen about that)
There is no reply.

* * *

>x self
You are wearing a watch.

As good-looking as ever.

* * *

>x watch
You can't see any such thing.

>inventory
You are carrying nothing.

>clothing
That's not a verb I recognise.

* * *

>x woman
You can't see any such thing.

>play game
You launch the game.

But before you get to the point of continuing your most recent campaign, something in your computer flashes, blinding you with bright golden light. Then you realize you're not alone anymore. A woman crashes upon you.

And if she were slender a maiden in distress, all should have been well, but this gigantic monster of a lady is in full medival armor when she lands on your head.

You are about to scream in pain. You are about to fight or flight because this is New York City, and having a stranger appearing in your place out of a sudden is a bad sign.

>ask her about sword
(Helen about the sword)
"Why are you even carrying a sword?" you ask, still fearing for your head.

The armor lady gives you the look like you're stupid, "Because I am a knight, and I am not taking off the sword my lady bestowed me when I was knighted."

Maybe this woman is an actress because that is so method.